TGAGTAGATTCTTTAAATG -> GAGTAGATTCTTTAAATGG
ATTTCGGACCAACAAGGAC -> TTTCGGACCAACAAGGACA
ATGCGCCAGAATTCCTACA -> TGCGCCAGAATTCCTACAA
CATCCAGGGCATTCCCTGC -> ATCCAGGGCATTCCCTGCT
GCAGATGTAGACATTGGTT -> CAGATGTAGACATTGGTTA
TGTTATTGGAAAGAGAGGG -> GTTATTGGAAAGAGAGGGA
AGCACTATAATGCTGTGCT -> GCACTATAATGCTGTGCTT
GCACCCCCTCGTCTATTAG -> CACCCCCTCGTCTATTAGA
CACTGAACATCTCGCGTTT -> ACTGAACATCTCGCGTTTG
CCGGAATTCAACTACCGTG -> CGGAATTCAACTACCGTGC
CGATGACGGCTCCCGGCCT -> GATGACGGCTCCCGGCCTT
TGAGCTCGCGTTTGAAGGT -> GAGCTCGCGTTTGAAGGTC
ATGTCCTTTACCAGGGTTT -> TGTCCTTTACCAGGGTTTT
GCTGCCTAATTCGCTGGTC -> CTGCCTAATTCGCTGGTCA
GGCAATACAGGACACCGGG -> GCAATACAGGACACCGGGC
TGGTAAAAAGTGTAACGAA -> GGTAAAAAGTGTAACGAAA
TCTGCGCCGTACCGTAACT -> CTGCGCCGTACCGTAACTC
GACATGATCAGGAGTACAT -> ACATGATCAGGAGTACATG
TGGTCAGTCTAAACACTTG -> GGTCAGTCTAAACACTTGA
TGAAGGTCTCCCGTTGAAT -> GAAGGTCTCCCGTTGAATA
CATGAAGCTCTTCCTAGAC -> ATGAAGCTCTTCCTAGACA
GATGGTGATGAACATCCCC -> ATGGTGATGAACATCCCCC
GGCCTACCCGTTCAGCAGT -> GCCTACCCGTTCAGCAGTC
TCCTATGTAGAATGGCTGG -> CCTATGTAGAATGGCTGGC
GAGATGAGACAGGTTAATT -> AGATGAGACAGGTTAATTA
GTGTGGAAGCCGTATGTCT -> TGTGGAAGCCGTATGTCTA
TGAGCGGGCTTGGCTTAGC -> GAGCGGGCTTGGCTTAGCA
GCCTACCCGTTCAGCAGTC -> CCTACCCGTTCAGCAGTCT
GTGGGGTCGCTGAGCGGGC -> TGGGGTCGCTGAGCGGGCT
ATCTGCGCCGTACCGTAAC -> TCTGCGCCGTACCGTAACT
GCTCAACGAATGGACACGT -> CTCAACGAATGGACACGTT
ACGGAAATTAGATAATATT -> CGGAAATTAGATAATATTA
AATAGCACGCTGTCGTCGG -> ATAGCACGCTGTCGTCGGG
CTATCTTTGTTCTCAGATA -> TATCTTTGTTCTCAGATAA
TCGTTATTCAGTCGTTTCT -> CGTTATTCAGTCGTTTCTT
CGTACCGATCTGCGCCGTA -> GTACCGATCTGCGCCGTAC
TACGATACAACAGTTATAG -> ACGATACAACAGTTATAGC
AAATAGATGCGAAATACGA -> AATAGATGCGAAATACGAG
GGCTGGTGCTTACTCATGC -> GCTGGTGCTTACTCATGCT
CCCCTCGGGAATTGCAGAT -> CCCTCGGGAATTGCAGATG
TATGTTATTGGAAAGAGAG -> ATGTTATTGGAAAGAGAGG
CCTTTCTCTTGTAACCCAT -> CTTTCTCTTGTAACCCATG
CTCGAGGCAATACAGGACA -> TCGAGGCAATACAGGACAC
CCATCATGTATGCCGGAAT -> CATCATGTATGCCGGAATT
ACACGTTGGAATTCCCTCG -> CACGTTGGAATTCCCTCGA
GTCAGGGTGGTCAGTCAAT -> TCAGGGTGGTCAGTCAATG
GGTCCGCTTCACAGAATAT -> GTCCGCTTCACAGAATATC
TGGTGATGAACATCCCCCT -> GGTGATGAACATCCCCCTC
TCACTGAACATCTCGCGTT -> CACTGAACATCTCGCGTTT
ACAGGACACCGGGCTTACG -> CAGGACACCGGGCTTACGA
TTCCGTATTTTTGAAGATG -> TCCGTATTTTTGAAGATGG
CCCATCATGTATGCCGGAA -> CCATCATGTATGCCGGAAT
CAGGGTTTTCGTTCCCAAC -> AGGGTTTTCGTTCCCAACA
GTTGCACCCCCTCGTCTAT -> TTGCACCCCCTCGTCTATT
GGCATTCCCTGCTTGGCAG -> GCATTCCCTGCTTGGCAGT
ACATGGACTCGTTATTCAG -> CATGGACTCGTTATTCAGT
TATCAGCCGACCCAGGAGG -> ATCAGCCGACCCAGGAGGG
CAAACAACACGGAAATTAG -> AAACAACACGGAAATTAGA
CCTCCCCTTTGCATCGAAT -> CTCCCCTTTGCATCGAATC
GCCTTTTAAATACTAAGGT -> CCTTTTAAATACTAAGGTA
CATCGATCGCCTGGCTCTT -> ATCGATCGCCTGGCTCTTC
GGGTCGCTGAGCGGGCTTG -> GGTCGCTGAGCGGGCTTGG
CTTCGAGAGTGTAGCTGAG -> TTCGAGAGTGTAGCTGAGT
AATTCCCTCGAGGCAATAC -> ATTCCCTCGAGGCAATACA
TATTTCCCTCATGAGACGA -> ATTTCCCTCATGAGACGAG
GAGAGAAACGCTTCTGAAG -> AGAGAAACGCTTCTGAAGT
TATTGGAAAGAGAGGGAGT -> ATTGGAAAGAGAGGGAGTA
TGCATCGAATCAAAGTCGG -> GCATCGAATCAAAGTCGGC
GTCCATTACGGGATGTCCT -> TCCATTACGGGATGTCCTT
GATAGCGAGAGTGGGGTCG -> ATAGCGAGAGTGGGGTCGC
CAGCCGAGATGAGACAGGT -> AGCCGAGATGAGACAGGTT
TCGCATTTATAAGTCCGTT -> CGCATTTATAAGTCCGTTA
CTTGCCACGAACCTGCCTG -> TTGCCACGAACCTGCCTGT
CGCCAGACACTTGCGGTTT -> GCCAGACACTTGCGGTTTC
TCTTTAATACGATACAACA -> CTTTAATACGATACAACAG
TTGGTGCTGAGATGCGCCA -> TGGTGCTGAGATGCGCCAG
TATGATAGGCGTAGTGCAT -> ATGATAGGCGTAGTGCATC
GAGTGGTGTAGGATCCTTT -> AGTGGTGTAGGATCCTTTT
TATCATGGAGCTGACGGCT -> ATCATGGAGCTGACGGCTG
CAAACCGTCAGGGTGGTCA -> AAACCGTCAGGGTGGTCAG
TGTCGTCGGGGGTCCGCTT -> GTCGTCGGGGGTCCGCTTC
AACGTGTGGAAGCCGTATG -> ACGTGTGGAAGCCGTATGT
GGCTGAAGATACAGAAAGG -> GCTGAAGATACAGAAAGGA
TGAGATGCGCCAGAATTCC -> GAGATGCGCCAGAATTCCT
ATGTCGGGAACTCCCTGTG -> TGTCGGGAACTCCCTGTGG
GAAGATACAGAAAGGAGTG -> AAGATACAGAAAGGAGTGA
TCTCCCGTTGAATAAGTGG -> CTCCCGTTGAATAAGTGGG
GGCAGTCTCCATATTTCGG -> GCAGTCTCCATATTTCGGA
ACAAGCTAAACTGCTTCGG -> CAAGCTAAACTGCTTCGGC
TAGCAAATTTTGGCGTCTA -> AGCAAATTTTGGCGTCTAT
AGTGGTGTAGGATCCTTTT -> GTGGTGTAGGATCCTTTTC
AATAGATGCGAAATACGAG -> ATAGATGCGAAATACGAGA
ACTATAATGCTGTGCTTAT -> CTATAATGCTGTGCTTATG
CACTTGCGGTTTCACCGAG -> ACTTGCGGTTTCACCGAGT
GCAATACAGGACACCGGGC -> CAATACAGGACACCGGGCT
TCGGGGGTCCGCTTCACAG -> CGGGGGTCCGCTTCACAGA
CCGATGTCGGGAACTCCCT -> CGATGTCGGGAACTCCCTG
TCATGCTAGGGTAAGAGTC -> CATGCTAGGGTAAGAGTCC
TTCCTAGCAAATTTTGGCG -> TCCTAGCAAATTTTGGCGT
TTTAATAGCACGCTGTCGT -> TTAATAGCACGCTGTCGTC
AGTCACGAACCAAACAACA -> GTCACGAACCAAACAACAC
TTTCAGATGGTGATGAACA -> TTCAGATGGTGATGAACAT
TTGGCCCCCAATAAACGCA -> TGGCCCCCAATAAACGCAA
GGCACCACAGGCCCTGTGG -> GCACCACAGGCCCTGTGGT
CTATTGGCCCCCAATAAAC -> TATTGGCCCCCAATAAACG
ATTTTGGCGTCTATCTGTT -> TTTTGGCGTCTATCTGTTG
ACCAGGGTTTTCGTTCCCA -> CCAGGGTTTTCGTTCCCAA
GGAATTCCCTCGAGGCAAT -> GAATTCCCTCGAGGCAATA
GTCGTCGGGGGTCCGCTTC -> TCGTCGGGGGTCCGCTTCA
TTTCACCGAGTGCCGAGGA -> TTCACCGAGTGCCGAGGAG
TTCAGTCGTTTCTTATTCC -> TCAGTCGTTTCTTATTCCA
GTACAGACATGGACTCGTT -> TACAGACATGGACTCGTTA
TGGCGACCTCGGGAGCAGC -> GGCGACCTCGGGAGCAGCT
AGGACTACCGAGCTTATTC -> GGACTACCGAGCTTATTCG
CTGCCTACTGACTGTCCGC -> TGCCTACTGACTGTCCGCC
TTTAAATACTAAGGTATTG -> TTAAATACTAAGGTATTGG
AAGCGTTAGGACTACCGAG -> AGCGTTAGGACTACCGAGC
CCGTTCCGTATTTTTGAAG -> CGTTCCGTATTTTTGAAGA
GCGTTAGGACTACCGAGCT -> CGTTAGGACTACCGAGCTT
GTTAGGTGTTCCTATTTAT -> TTAGGTGTTCCTATTTATG
TCCGCCATGATCTTGCCAC -> CCGCCATGATCTTGCCACG
AGATGCGCCAGAATTCCTA -> GATGCGCCAGAATTCCTAC
CACGTTAGGTGTTCCTATT -> ACGTTAGGTGTTCCTATTT
GGCACGAGTTAGAATCAGG -> GCACGAGTTAGAATCAGGT
AGCTTATTCGGGATTGACC -> GCTTATTCGGGATTGACCG
AACCAAACAACACGGAAAT -> ACCAAACAACACGGAAATT
AGGTGGGCCTCCTCCACAA -> GGTGGGCCTCCTCCACAAA
GTCTCATGCGGCGTCTGTG -> TCTCATGCGGCGTCTGTGG
CGGACCAACAAGGACATGA -> GGACCAACAAGGACATGAT
GGTAAAAAGTGTAACGAAA -> GTAAAAAGTGTAACGAAAC
GAACCTGCCTGTCAGATTT -> AACCTGCCTGTCAGATTTC
GATGGAGTCGACCCATCCA -> ATGGAGTCGACCCATCCAG
AGCAGCTATCTTTGTTCTC -> GCAGCTATCTTTGTTCTCA
GGCACGGTCTAGTTAAACG -> GCACGGTCTAGTTAAACGA
AGTGTAGCTGAGTAGATTC -> GTGTAGCTGAGTAGATTCT
AATACTAAGGTATTGGTGC -> ATACTAAGGTATTGGTGCT
GCGCGGTCACGTTAGGTGT -> CGCGGTCACGTTAGGTGTT
CAAGCTAAACTGCTTCGGC -> AAGCTAAACTGCTTCGGCA
GGTCTCTAGTCACGAACCA -> GTCTCTAGTCACGAACCAA
TGTAACCCATGAACCGTAC -> GTAACCCATGAACCGTACC
AAACGCTTCTGAAGTCCTC -> AACGCTTCTGAAGTCCTCC
AGTCCGTTATCATGGAGCT -> GTCCGTTATCATGGAGCTG
CGCGTTTGAAGGTCTCTGC -> GCGTTTGAAGGTCTCTGCG
GACGGCGGCGCCTTTGCGT -> ACGGCGGCGCCTTTGCGTC
TAACCCATGAACCGTACCG -> AACCCATGAACCGTACCGG
TCCATTCAGATGAACATTC -> CCATTCAGATGAACATTCG
AAATACACAGACTATTTTC -> AATACACAGACTATTTTCT
GACATTGGTTAGGGCCTAC -> ACATTGGTTAGGGCCTACC
GTAAGAGTCCATTACGGGA -> TAAGAGTCCATTACGGGAT
CAGGTTAATTACTGGCCGT -> AGGTTAATTACTGGCCGTT
GCTGACGGCTGGTGCTTAC -> CTGACGGCTGGTGCTTACT
TTGACCGTGGGTCGCATTC -> TGACCGTGGGTCGCATTCA
TTGTTCTCAGATAAGGGGA -> TGTTCTCAGATAAGGGGAG
TCACAGAATATCACAATAC -> CACAGAATATCACAATACG
ACGCAAGGGCAAATAGATG -> CGCAAGGGCAAATAGATGC
GTGCCGAGGAGGGATAGCT -> TGCCGAGGAGGGATAGCTC
GTTATTGGAAAGAGAGGGA -> TTATTGGAAAGAGAGGGAG
AGAATTCCTACAAGTGGTC -> GAATTCCTACAAGTGGTCA
ATTAACGAAATACACAGAC -> TTAACGAAATACACAGACT
CGCCGTACCGTAACTCCTG -> GCCGTACCGTAACTCCTGT
AGGGCTGCCTAATTCGCTG -> GGGCTGCCTAATTCGCTGG
CCGTGGGTCGCATTCAAAG -> CGTGGGTCGCATTCAAAGA
CGAACCAAACAACACGGAA -> GAACCAAACAACACGGAAA
GGTTTTCGTATGCGGGATG -> GTTTTCGTATGCGGGATGT
CAGTCTAAACACTTGAGGG -> AGTCTAAACACTTGAGGGT
GGAGGGCCCCATGCTACGT -> GAGGGCCCCATGCTACGTT
CCGTTCAGCAGTCTCCAAA -> CGTTCAGCAGTCTCCAAAG
CCCGTTGAATAAGTGGGGT -> CCGTTGAATAAGTGGGGTG
CAAATAGATGCGAAATACG -> AAATAGATGCGAAATACGA
TGTAACGAAACCGACTATC -> GTAACGAAACCGACTATCT
CTATTTCCCTCATGAGACG -> TATTTCCCTCATGAGACGA
GGAGGGATAGCTCTTACCC -> GAGGGATAGCTCTTACCCG
TCTGTTGACCCGTGGACGG -> CTGTTGACCCGTGGACGGC
AAGTCGGCCTTTCTCTTGT -> AGTCGGCCTTTCTCTTGTA
ACATGGCACGGTCTAGTTA -> CATGGCACGGTCTAGTTAA
ATGAAGCTCTTCCTAGACA -> TGAAGCTCTTCCTAGACAT
CGGTCTAGTTAAACGAATT -> GGTCTAGTTAAACGAATTT
AGCGGGCTTGGCTTAGCAC -> GCGGGCTTGGCTTAGCACT
ACCGGAACATCGCATTTAT -> CCGGAACATCGCATTTATA
CTTACGACGCCCCTCGGGA -> TTACGACGCCCCTCGGGAA
GCCCCCCCATCATGTATGC -> CCCCCCCATCATGTATGCC
ACACTTGAGGGTAGAACCA -> CACTTGAGGGTAGAACCAG
GAGGCAATACAGGACACCG -> AGGCAATACAGGACACCGG
TGTAGACATTGGTTAGGGC -> GTAGACATTGGTTAGGGCC
GTGCCCAAACCGTCAGGGT -> TGCCCAAACCGTCAGGGTG
ATGGCACGGTCTAGTTAAA -> TGGCACGGTCTAGTTAAAC
CCTGTGGTGGTAAAAAGTG -> CTGTGGTGGTAAAAAGTGT
TGTAGCTGAGTAGATTCTT -> GTAGCTGAGTAGATTCTTT
CACTTGAGGGTAGAACCAG -> ACTTGAGGGTAGAACCAGC
GCTTGGCAGTCTCCATATT -> CTTGGCAGTCTCCATATTT
CAGGAGTACATGAAGCTCT -> AGGAGTACATGAAGCTCTT
TTGTAACCCATGAACCGTA -> TGTAACCCATGAACCGTAC
ACTATGCGCGGTCACGTTA -> CTATGCGCGGTCACGTTAG
GGTGCTGAGATGCGCCAGA -> GTGCTGAGATGCGCCAGAA
ACAGAATATCACAATACGT -> CAGAATATCACAATACGTC
CCTGCCTGTCAGATTTCAG -> CTGCCTGTCAGATTTCAGA
CCCGTGGACGGCGGCGCCT -> CCGTGGACGGCGGCGCCTT
GTGGAAGCCGTATGTCTAC -> TGGAAGCCGTATGTCTACC
ACCGTAACTCCTGTCAGTT -> CCGTAACTCCTGTCAGTTC
ACTCGCGTTTGAAGGTCTC -> CTCGCGTTTGAAGGTCTCA
GGGATAGCTCTTACCCGTC -> GGATAGCTCTTACCCGTCC
GGTCTCCCGTTGAATAAGT -> GTCTCCCGTTGAATAAGTG
GTTGAATAAGTGGGGTGCA -> TTGAATAAGTGGGGTGCAT
AATCAGGTGGGCCTCCTCC -> ATCAGGTGGGCCTCCTCCA
TTTATGATCTTTAATACGA -> TTATGATCTTTAATACGAT
CCCCCATCATGTATGCCGG -> CCCCATCATGTATGCCGGA
CTAAGGTATTGGTGCTGAG -> TAAGGTATTGGTGCTGAGA
CTGACTGTCCGCCATGATC -> TGACTGTCCGCCATGATCT
TATTTTTGAAGATGGAGTC -> ATTTTTGAAGATGGAGTCG
AAATTTTGGCGTCTATCTG -> AATTTTGGCGTCTATCTGT
GGGTAGAACCAGCCGAGAT -> GGTAGAACCAGCCGAGATG
CGGGAATTGCAGATGTAGA -> GGGAATTGCAGATGTAGAC
ATCCTTTTCCGGCACGAGT -> TCCTTTTCCGGCACGAGTT
TGATATGTTATTGGAAAGA -> GATATGTTATTGGAAAGAG
TCTAAACACTTGAGGGTAG -> CTAAACACTTGAGGGTAGA
TGGCCCCCAATAAACGCAA -> GGCCCCCAATAAACGCAAG
GTCGTACAGACATGGACTC -> TCGTACAGACATGGACTCG
ACGTCCGTCCGTAAATGGC -> CGTCCGTCCGTAAATGGCG
TCAGCCGACCCAGGAGGGC -> CAGCCGACCCAGGAGGGCC
CGCGTTTGAAGGTCTCATG -> GCGTTTGAAGGTCTCATGC
GCTTATGATTGCTACCGGA -> CTTATGATTGCTACCGGAA
ACGAATTTTGTTCTTGCAG -> CGAATTTTGTTCTTGCAGC
ATTCGGGATTGACCGTGGG -> TTCGGGATTGACCGTGGGT
CAACACGGAAATTAGATAA -> AACACGGAAATTAGATAAT
ACCAACAAGGACATGATCA -> CCAACAAGGACATGATCAG
TCGTTTCTTATTCCATTCA -> CGTTTCTTATTCCATTCAG
AGACTATTTTCTTGACGTC -> GACTATTTTCTTGACGTCC
CTCCCGGCCTTTTAAATAC -> TCCCGGCCTTTTAAATACT
GCGTTTGAAGGTCTCCCGT -> CGTTTGAAGGTCTCCCGTT
TTCGCTGGTCAACCCAGTC -> TCGCTGGTCAACCCAGTCA
ATAGCTCTTACCCGTCCTA -> TAGCTCTTACCCGTCCTAT
GTTCCTATTTATGATCTTT -> TTCCTATTTATGATCTTTA
CATCCGATGTCGGGAACTC -> ATCCGATGTCGGGAACTCC
GGCGTAGTGCATCCGATGT -> GCGTAGTGCATCCGATGTC
GGCTTACGACGCCCCTCGG -> GCTTACGACGCCCCTCGGG
CTATTTATGATCTTTAATA -> TATTTATGATCTTTAATAC
CCGAGATGAGACAGGTTAA -> CGAGATGAGACAGGTTAAT
AGCCGACCCAGGAGGGCCC -> GCCGACCCAGGAGGGCCCC
GGGATGTACTAAGGGAGTC -> GGATGTACTAAGGGAGTCG
CCCCTTTGCATCGAATCAA -> CCCTTTGCATCGAATCAAA
AGAAACGCTTCTGAAGTCC -> GAAACGCTTCTGAAGTCCT
ACTGACTGTCCGCCATGAT -> CTGACTGTCCGCCATGATC
CAATACGTCGGGGGGTGCC -> AATACGTCGGGGGGTGCCG
CTAATTCACTTGATATGTT -> TAATTCACTTGATATGTTA
GAATAAGTGGGGTGCATTA -> AATAAGTGGGGTGCATTAG
GGCCCTGTGGTGGTAAAAA -> GCCCTGTGGTGGTAAAAAG
TCGGCACATGGCCGCCAGA -> CGGCACATGGCCGCCAGAC
AACATCTCGCGTTTGAAGG -> ACATCTCGCGTTTGAAGGT
GCGCCGTACCGTAACTCCT -> CGCCGTACCGTAACTCCTG
TTGATATGTTATTGGAAAG -> TGATATGTTATTGGAAAGA
ACCCGTGGACGGCGGCGCC -> CCCGTGGACGGCGGCGCCT
CATTCAGATGAACATTCGG -> ATTCAGATGAACATTCGGA
CAGATGAACATTCGGATAG -> AGATGAACATTCGGATAGC
CTCCGTCACTGAACATCTC -> TCCGTCACTGAACATCTCG
TTAGATAATATTATCAGCC -> TAGATAATATTATCAGCCG
ACCGAGTGCCGAGGAGGGA -> CCGAGTGCCGAGGAGGGAT
TCGCGTTTGAAGGTCTCGT -> CGCGTTTGAAGGTCTCGTC
AGACATGGCACGGTCTAGT -> GACATGGCACGGTCTAGTT
ACACAGACTATTTTCTTGA -> CACAGACTATTTTCTTGAC
ACTGCTTCGGCATAAACGA -> CTGCTTCGGCATAAACGAA
CTCAACGAATGGACACGTT -> TCAACGAATGGACACGTTG
ACTGGCCGTTCCGTATTTT -> CTGGCCGTTCCGTATTTTT
CGTCGGGGGTCCGCTTCAC -> GTCGGGGGTCCGCTTCACA
GCAGCTATCTTTGTTCTCA -> CAGCTATCTTTGTTCTCAG
GACTGTCCGCCATGATCTT -> ACTGTCCGCCATGATCTTG
TCCGTATTAACGAAATACA -> CCGTATTAACGAAATACAC
CCCTCGGGAATTGCAGATG -> CCTCGGGAATTGCAGATGT
ACGTTGGAATTCCCTCGAG -> CGTTGGAATTCCCTCGAGG
CGTTGGAATTCCCTCGAGG -> GTTGGAATTCCCTCGAGGC
TTATGTGAGTGGGGTGCAT -> TATGTGAGTGGGGTGCATT
GGACTCGTTATTCAGTCGT -> GACTCGTTATTCAGTCGTT
GTAACGAAACCGACTATCT -> TAACGAAACCGACTATCTA
TCAAAGTCGGCCTTTCTCT -> CAAAGTCGGCCTTTCTCTT
TTAATACGATACAACAGTT -> TAATACGATACAACAGTTA
GTTAATTACTGGCCGTTCC -> TTAATTACTGGCCGTTCCG
CCTTTTCCGGCACGAGTTA -> CTTTTCCGGCACGAGTTAG
AGATGGTGATGAACATCCC -> GATGGTGATGAACATCCCC
TTAAATGGACGGCGTACCG -> TAAATGGACGGCGTACCGA
TTAACTATGGAAGCGTTAG -> TAACTATGGAAGCGTTAGG
ACTTGAGGGTAGAACCAGC -> CTTGAGGGTAGAACCAGCC
GGCGACCTCGGGAGCAGCT -> GCGACCTCGGGAGCAGCTA
CGAGGCAATACAGGACACC -> GAGGCAATACAGGACACCG
TGCGACATCGATCGCCTGG -> GCGACATCGATCGCCTGGC
CTCCCGTTGAATAAGTGGG -> TCCCGTTGAATAAGTGGGG
ATATGTTATTGGAAAGAGA -> TATGTTATTGGAAAGAGAG
ATAGCACGCTGTCGTCGGG -> TAGCACGCTGTCGTCGGGG
TCTGGAACTCGCGTTTGAA -> CTGGAACTCGCGTTTGAAG
GGAGTAGGGACCTATTGGC -> GAGTAGGGACCTATTGGCC
TGAAGTCCTCCCCTTTGCA -> GAAGTCCTCCCCTTTGCAT
GTACTAAGGGAGTCGTGTT -> TACTAAGGGAGTCGTGTTC
CCCAGGAGGGCCCCATGCT -> CCAGGAGGGCCCCATGCTA
AGCTATCTTTGTTCTCAGA -> GCTATCTTTGTTCTCAGAT
ACGGCGTACCGATCTGCGC -> CGGCGTACCGATCTGCGCC
CCTACCCGTTCAGCAGTCT -> CTACCCGTTCAGCAGTCTC
TCAGGAGTACATGAAGCTC -> CAGGAGTACATGAAGCTCT
ACTAAGGTATTGGTGCTGA -> CTAAGGTATTGGTGCTGAG
CCCAGTCAGTGCCCAAACC -> CCAGTCAGTGCCCAAACCG
TTTCGGACCAACAAGGACA -> TTCGGACCAACAAGGACAT
TAGCTCTTACCCGTCCTAT -> AGCTCTTACCCGTCCTATG
TGATCAGGAGTACATGAAG -> GATCAGGAGTACATGAAGC
CAGGAGGGCCCCATGCTAC -> AGGAGGGCCCCATGCTACG
CTACAAGTGGTCAGTCTAA -> TACAAGTGGTCAGTCTAAA
TGAAGATGGAGTCGACCCA -> GAAGATGGAGTCGACCCAT
AGAGTGTAGCTGAGTAGAT -> GAGTGTAGCTGAGTAGATT
TCCCTGTGGTCTGTTGCAC -> CCCTGTGGTCTGTTGCACC
TAGACATGGCACGGTCTAG -> AGACATGGCACGGTCTAGT
TGCAGCTCAACGAATGGAC -> GCAGCTCAACGAATGGACA
TGCCGGAATTCAACTACCG -> GCCGGAATTCAACTACCGT
ATACGAGATCGGCACATGG -> TACGAGATCGGCACATGGC
ATCTTTAATACGATACAAC -> TCTTTAATACGATACAACA
TCTTACCCGTCCTATGTAG -> CTTACCCGTCCTATGTAGA
TCGCTGAGCGGGCTTGGCT -> CGCTGAGCGGGCTTGGCTT
TTAACGTGTGGAAGCCGTA -> TAACGTGTGGAAGCCGTAT
GTAGGATCCTTTTCCGGCA -> TAGGATCCTTTTCCGGCAC
TCTAATTCACTTGATATGT -> CTAATTCACTTGATATGTT
TTTGGCGTCTATCTGTTGA -> TTGGCGTCTATCTGTTGAC
GTATTTTTGAAGATGGAGT -> TATTTTTGAAGATGGAGTC
ATAAACGCAAGGGCAAATA -> TAAACGCAAGGGCAAATAG
TCACAATACGTCGGGGGGT -> CACAATACGTCGGGGGGTG
GTCAGTGCCCAAACCGTCA -> TCAGTGCCCAAACCGTCAG
CGTTCCGTATTTTTGAAGA -> GTTCCGTATTTTTGAAGAT
TAAGGTATTGGTGCTGAGA -> AAGGTATTGGTGCTGAGAT
GATCTTGCCACGAACCTGC -> ATCTTGCCACGAACCTGCC
CCTACTGACTGTCCGCCAT -> CTACTGACTGTCCGCCATG
TACTGGCCGTTCCGTATTT -> ACTGGCCGTTCCGTATTTT
GAGATCCCTCGCGTTTGAA -> AGATCCCTCGCGTTTGAAG
CCTATTTATGATCTTTAAT -> CTATTTATGATCTTTAATA
GCCTTTACTTCGAGAGTGT -> CCTTTACTTCGAGAGTGTA
TGCGATGACGGCTCCCGGC -> GCGATGACGGCTCCCGGCC
TTTGTTCTTGCAGCTCAAC -> TTGTTCTTGCAGCTCAACG
TTATTCGGGATTGACCGTG -> TATTCGGGATTGACCGTGG
GCTGCCTACTGACTGTCCG -> CTGCCTACTGACTGTCCGC
GCCGACCCAGGAGGGCCCC -> CCGACCCAGGAGGGCCCCA
AACTGCTTCGGCATAAACG -> ACTGCTTCGGCATAAACGA
CAGATAAGGGGAGTGGTGT -> AGATAAGGGGAGTGGTGTA
CAAATTTTGGCGTCTATCT -> AAATTTTGGCGTCTATCTG
AATAAGTGGGGTGCATTAG -> ATAAGTGGGGTGCATTAGG
GATGAGACAGGTTAATTAC -> ATGAGACAGGTTAATTACT
ACTAAGGGAGTCGTGTTCC -> CTAAGGGAGTCGTGTTCCC
GGGTTTTCGTTCCCAACAA -> GGTTTTCGTTCCCAACAAG
TTATAAGTCCGTTATCATG -> TATAAGTCCGTTATCATGG
TTGCATCGAATCAAAGTCG -> TGCATCGAATCAAAGTCGG
TCCGTTATCATGGAGCTGA -> CCGTTATCATGGAGCTGAC
TTGTGGGGTGCATTAGGGC -> TGTGGGGTGCATTAGGGCT
GCTTATTCGGGATTGACCG -> CTTATTCGGGATTGACCGT
CAACGAATGGACACGTTGG -> AACGAATGGACACGTTGGA
AGGAGTACATGAAGCTCTT -> GGAGTACATGAAGCTCTTC
CCGTGCGATGACGGCTCCC -> CGTGCGATGACGGCTCCCG
TTTTCCGGCACGAGTTAGA -> TTTCCGGCACGAGTTAGAA
TCTCCATATTTCGGACCAA -> CTCCATATTTCGGACCAAC
TATGTGAGTGGGGTGCATT -> ATGTGAGTGGGGTGCATTA
ATCCAGGGCATTCCCTGCT -> TCCAGGGCATTCCCTGCTT
TTTCTTATTCCATTCAGAT -> TTCTTATTCCATTCAGATG
TAATTCGCTGGTCAACCCA -> AATTCGCTGGTCAACCCAG
GTTAGGGCCTACCCGTTCA -> TTAGGGCCTACCCGTTCAG
AGCCTTTACTTCGAGAGTG -> GCCTTTACTTCGAGAGTGT
TCGGGAATTGCAGATGTAG -> CGGGAATTGCAGATGTAGA
CCCATCCAGGGCATTCCCT -> CCATCCAGGGCATTCCCTG
GACCGTGGGTCGCATTCAA -> ACCGTGGGTCGCATTCAAA
TCACCGAGTGCCGAGGAGG -> CACCGAGTGCCGAGGAGGG
TAGGGCCTACCCGTTCAGC -> AGGGCCTACCCGTTCAGCA
AACGAATGGACACGTTGGA -> ACGAATGGACACGTTGGAA
TTCGGATAGCGAGAGTGGG -> TCGGATAGCGAGAGTGGGG
TGGCACCACAGGCCCTGTG -> GGCACCACAGGCCCTGTGG
GATCCTTTTCCGGCACGAG -> ATCCTTTTCCGGCACGAGT
ATTTCAGATGGTGATGAAC -> TTTCAGATGGTGATGAACA
GTTTAATAGCACGCTGTCG -> TTTAATAGCACGCTGTCGT
CGTATTAACGAAATACACA -> GTATTAACGAAATACACAG
CGTACAGACATGGACTCGT -> GTACAGACATGGACTCGTT
TTCTTGCAGCTCAACGAAT -> TCTTGCAGCTCAACGAATG
GTCAGATTTCAGATGGTGA -> TCAGATTTCAGATGGTGAT
GATCAGGAGTACATGAAGC -> ATCAGGAGTACATGAAGCT
GCCTACTGACTGTCCGCCA -> CCTACTGACTGTCCGCCAT
CTCCTTCCTAGCAAATTTT -> TCCTTCCTAGCAAATTTTG
AATATTATCAGCCGACCCA -> ATATTATCAGCCGACCCAG
TTCCTATTTCCCTCATGAG -> TCCTATTTCCCTCATGAGA
TGATCTTTAATACGATACA -> GATCTTTAATACGATACAA
GGTCGCATTCAAAGAGAGA -> GTCGCATTCAAAGAGAGAA
CCTCATGAGACGAGCCTCG -> CTCATGAGACGAGCCTCGT
TGAACATCCCCCTCGTCTG -> GAACATCCCCCTCGTCTGG
TCGTTCCCAACAAGCTAAA -> CGTTCCCAACAAGCTAAAC
TAAACGAAGGCCGGGTCTC -> AAACGAAGGCCGGGTCTCT
GGAAATTAGATAATATTAT -> GAAATTAGATAATATTATC
CTTCCTAGCAAATTTTGGC -> TTCCTAGCAAATTTTGGCG
TTATGATCTTTAATACGAT -> TATGATCTTTAATACGATA
TTTCCGGCACGAGTTAGAA -> TTCCGGCACGAGTTAGAAT
AGGGCCTACCCGTTCAGCA -> GGGCCTACCCGTTCAGCAG
TATAATGCTGTGCTTATGA -> ATAATGCTGTGCTTATGAT
AGATAATATTATCAGCCGA -> GATAATATTATCAGCCGAC
ATCTTGCCACGAACCTGCC -> TCTTGCCACGAACCTGCCT
CCAACAAGCTAAACTGCTT -> CAACAAGCTAAACTGCTTC
TTATTCAGTCGTTTCTTAT -> TATTCAGTCGTTTCTTATT
GTGTTCCCGTTTATGCGAC -> TGTTCCCGTTTATGCGACA
TATGATTGCTACCGGAACA -> ATGATTGCTACCGGAACAT
GATGACGGCTCCCGGCCTT -> ATGACGGCTCCCGGCCTTT
TCCGATGTCGGGAACTCCC -> CCGATGTCGGGAACTCCCT
CTCTGCGGTGCCTTGTGGG -> TCTGCGGTGCCTTGTGGGG
ACTATCTAATTCACTTGAT -> CTATCTAATTCACTTGATA
GGACCTATTGGCCCCCAAT -> GACCTATTGGCCCCCAATA
CGGCCTTTTAAATACTAAG -> GGCCTTTTAAATACTAAGG
TGGCAGTCTCCATATTTCG -> GGCAGTCTCCATATTTCGG
TGTCTACCTCCGTCACTGA -> GTCTACCTCCGTCACTGAA
CCCTGCTTGGCAGTCTCCA -> CCTGCTTGGCAGTCTCCAT
TCCCGTTTATGCGACATCG -> CCCGTTTATGCGACATCGA
CTTGAGGGTAGAACCAGCC -> TTGAGGGTAGAACCAGCCG
TAAACACTTGAGGGTAGAA -> AAACACTTGAGGGTAGAAC
TTTAACGTGTGGAAGCCGT -> TTAACGTGTGGAAGCCGTA
AATACACAGACTATTTTCT -> ATACACAGACTATTTTCTT
GTGAGCTCGCGTTTGAAGG -> TGAGCTCGCGTTTGAAGGT
TCTTTGTTCTCAGATAAGG -> CTTTGTTCTCAGATAAGGG
TTTACTTCGAGAGTGTAGC -> TTACTTCGAGAGTGTAGCT
TCTAGTTAAACGAATTTTG -> CTAGTTAAACGAATTTTGT
CCCTGTGGTGGTAAAAAGT -> CCTGTGGTGGTAAAAAGTG
TTGCGTCGTTTTCGTCGGG -> TGCGTCGTTTTCGTCGGGC
CCCCTCGTCTATTAGAGGT -> CCCTCGTCTATTAGAGGTC
GGTTTTCGTTCCCAACAAG -> GTTTTCGTTCCCAACAAGC
CAACAAGGACATGATCAGG -> AACAAGGACATGATCAGGA
GGGCAAATAGATGCGAAAT -> GGCAAATAGATGCGAAATA
GGGCTTACGACGCCCCTCG -> GGCTTACGACGCCCCTCGG
AAATGGCGACCTCGGGAGC -> AATGGCGACCTCGGGAGCA
CGCTGTCGTCGGGGGTCCG -> GCTGTCGTCGGGGGTCCGC
TAGAATCAGGTGGGCCTCC -> AGAATCAGGTGGGCCTCCT
AAGCTCCTTCCTAGCAAAT -> AGCTCCTTCCTAGCAAATT
GACATGGACTCGTTATTCA -> ACATGGACTCGTTATTCAG
ATTTAACGTGTGGAAGCCG -> TTTAACGTGTGGAAGCCGT
ATCAAAGTCGGCCTTTCTC -> TCAAAGTCGGCCTTTCTCT
TAGGACTACCGAGCTTATT -> AGGACTACCGAGCTTATTC
CGAATTTTGTTCTTGCAGC -> GAATTTTGTTCTTGCAGCT
TGAATAAGTGGGGTGCATT -> GAATAAGTGGGGTGCATTA
GAATTCCTACAAGTGGTCA -> AATTCCTACAAGTGGTCAG
GCCGCCAGACACTTGCGGT -> CCGCCAGACACTTGCGGTT
TTTGAAGATGGAGTCGACC -> TTGAAGATGGAGTCGACCC
TGGGCCTCCTCCACAAAAT -> GGGCCTCCTCCACAAAATG
TTTTTGAAGATGGAGTCGA -> TTTTGAAGATGGAGTCGAC
GTACCGTAACTCCTGTCAG -> TACCGTAACTCCTGTCAGT
AGTCGACCCATCCAGGGCA -> GTCGACCCATCCAGGGCAT
GTGTAGCTGAGTAGATTCT -> TGTAGCTGAGTAGATTCTT
GAGGGAGTAGGGACCTATT -> AGGGAGTAGGGACCTATTG
GCATTTATAAGTCCGTTAT -> CATTTATAAGTCCGTTATC
TATGCGCGGTCACGTTAGG -> ATGCGCGGTCACGTTAGGT
CCTATGTAGAATGGCTGGC -> CTATGTAGAATGGCTGGCC
TGGCGTCTATCTGTTGACC -> GGCGTCTATCTGTTGACCC
GCGTCTATCTGTTGACCCG -> CGTCTATCTGTTGACCCGT
CATTAGGGCTGCATCCGTA -> ATTAGGGCTGCATCCGTAT
CGACTATCTAATTCACTTG -> GACTATCTAATTCACTTGA
CCCGTTCAGCAGTCTCCAA -> CCGTTCAGCAGTCTCCAAA
GCCAGACACTTGCGGTTTC -> CCAGACACTTGCGGTTTCA
ACTCCCTGTGGTCTGTTGC -> CTCCCTGTGGTCTGTTGCA
TCTTCTATGGCACCACAGG -> CTTCTATGGCACCACAGGC
AGACAGGTTAATTACTGGC -> GACAGGTTAATTACTGGCC
GGTGCATTAGGGCTGCCTA -> GTGCATTAGGGCTGCCTAC,GTGCATTAGGGCTGCCTAA
GTCAACCCAGTCAGTGCCC -> TCAACCCAGTCAGTGCCCA
ACTTGATATGTTATTGGAA -> CTTGATATGTTATTGGAAA
CGTCACTGAACATCTCGCG -> GTCACTGAACATCTCGCGT
TCCGTCCGTAAATGGCGAC -> CCGTCCGTAAATGGCGACC
TTTGCGTCGTTTTCGTCGG -> TTGCGTCGTTTTCGTCGGG
TTATTCCATTCAGATGAAC -> TATTCCATTCAGATGAACA
TCGGGCTACTATGCGCGGT -> CGGGCTACTATGCGCGGTC
AGCTCTTACCCGTCCTATG -> GCTCTTACCCGTCCTATGT
GTACATGAAGCTCTTCCTA -> TACATGAAGCTCTTCCTAG
ATGGACACGTTGGAATTCC -> TGGACACGTTGGAATTCCC
CGAACCTGCCTGTCAGATT -> GAACCTGCCTGTCAGATTT
GGCCGCCAGACACTTGCGG -> GCCGCCAGACACTTGCGGT
ATGCTAGGGTAAGAGTCCA -> TGCTAGGGTAAGAGTCCAT
GTCGGGGGGTGCCGGTGAA -> TCGGGGGGTGCCGGTGAAA
GCATCCGATGTCGGGAACT -> CATCCGATGTCGGGAACTC
CTTTGCATCGAATCAAAGT -> TTTGCATCGAATCAAAGTC
ATGCGGGATGTACTAAGGG -> TGCGGGATGTACTAAGGGA
TCTACCTCCGTCACTGAAC -> CTACCTCCGTCACTGAACA
GTTTATGCGACATCGATCG -> TTTATGCGACATCGATCGC
GAGAGTGTAGCTGAGTAGA -> AGAGTGTAGCTGAGTAGAT
TCGGGAGCAGCTATCTTTG -> CGGGAGCAGCTATCTTTGT
GATTGACCGTGGGTCGCAT -> ATTGACCGTGGGTCGCATT
TCTGTTGCACCCCCTCGTC -> CTGTTGCACCCCCTCGTCT
TCTTATTCCATTCAGATGA -> CTTATTCCATTCAGATGAA
GAACCAAACAACACGGAAA -> AACCAAACAACACGGAAAT
GGTGCATTAGGGCTGAAGA -> GTGCATTAGGGCTGAAGAT
CTGTTGACCCGTGGACGGC -> TGTTGACCCGTGGACGGCG
GTTTAAGCTCCTTCCTAGC -> TTTAAGCTCCTTCCTAGCA
GTCGGCCTTTCTCTTGTAA -> TCGGCCTTTCTCTTGTAAC
CCCCATGCTACGTTTAATA -> CCCATGCTACGTTTAATAG
CATCGAATCAAAGTCGGCC -> ATCGAATCAAAGTCGGCCT
TAACGTGTGGAAGCCGTAT -> AACGTGTGGAAGCCGTATG
GTTCCGTATTTTTGAAGAT -> TTCCGTATTTTTGAAGATG
CATTAGGGCTGAAGATACA -> ATTAGGGCTGAAGATACAG
GACACCGGGCTTACGACGC -> ACACCGGGCTTACGACGCC
TGGCCGTTCCGTATTTTTG -> GGCCGTTCCGTATTTTTGA
CTCGTCTTATGTGAGTGGG -> TCGTCTTATGTGAGTGGGG
TGAACATCTCGCGTTTGAA -> GAACATCTCGCGTTTGAAG
AAGATACAGAAAGGAGTGA -> AGATACAGAAAGGAGTGAG
TTGGTTAGGGCCTACCCGT -> TGGTTAGGGCCTACCCGTT
GTAGCTGAGTAGATTCTTT -> TAGCTGAGTAGATTCTTTA
ATGTGAGTGGGGTGCATTA -> TGTGAGTGGGGTGCATTAG
GTGGACGGCGGCGCCTTTG -> TGGACGGCGGCGCCTTTGC
GAAGGTCTCGTCTTATGTG -> AAGGTCTCGTCTTATGTGA
TGGAAGCCGTATGTCTACC -> GGAAGCCGTATGTCTACCT
TTACTGGCCGTTCCGTATT -> TACTGGCCGTTCCGTATTT
ACTATTTTCTTGACGTCCG -> CTATTTTCTTGACGTCCGT
ACATGAAGCTCTTCCTAGA -> CATGAAGCTCTTCCTAGAC
AGGGTAAGAGTCCATTACG -> GGGTAAGAGTCCATTACGG
CCGAGTGCCGAGGAGGGAT -> CGAGTGCCGAGGAGGGATA
CTACGTTTAATAGCACGCT -> TACGTTTAATAGCACGCTG
GGTTAATTACTGGCCGTTC -> GTTAATTACTGGCCGTTCC
AACACGGAAATTAGATAAT -> ACACGGAAATTAGATAATA
GGCGTACCGATCTGCGCCG -> GCGTACCGATCTGCGCCGT
GAGTGGGGTGCATTAGGGC -> AGTGGGGTGCATTAGGGCT
ACGAGATCGGCACATGGCC -> CGAGATCGGCACATGGCCG
GACCTATTGGCCCCCAATA -> ACCTATTGGCCCCCAATAA
GGATCCTTTTCCGGCACGA -> GATCCTTTTCCGGCACGAG
ACTTGCGGTTTCACCGAGT -> CTTGCGGTTTCACCGAGTG
TCGAATCAAAGTCGGCCTT -> CGAATCAAAGTCGGCCTTT
ACATCCCCCTCGTCTGGAA -> CATCCCCCTCGTCTGGAAC
TGGACACGTTGGAATTCCC -> GGACACGTTGGAATTCCCT
CGTTTATGCGACATCGATC -> GTTTATGCGACATCGATCG
AACGAATTTTGTTCTTGCA -> ACGAATTTTGTTCTTGCAG
CCGTATGTCTACCTCCGTC -> CGTATGTCTACCTCCGTCA
AACTACCGTGCGATGACGG -> ACTACCGTGCGATGACGGC
TAGAATGGCTGGCCGTTCC -> AGAATGGCTGGCCGTTCCT
CGTTTCTTATTCCATTCAG -> GTTTCTTATTCCATTCAGA
GTATTAACGAAATACACAG -> TATTAACGAAATACACAGA
GTGGTGTAGGATCCTTTTC -> TGGTGTAGGATCCTTTTCC
TGCGCGGTCACGTTAGGTG -> GCGCGGTCACGTTAGGTGT
TCAACGAATGGACACGTTG -> CAACGAATGGACACGTTGG
ATGGACTCGTTATTCAGTC -> TGGACTCGTTATTCAGTCG
CGGTTTAAGCTCCTTCCTA -> GGTTTAAGCTCCTTCCTAG
CGTCCGTCCGTAAATGGCG -> GTCCGTCCGTAAATGGCGA
TCGGGGGGTGCCGGTGAAA -> CGGGGGGTGCCGGTGAAAT
ATGATCAGGAGTACATGAA -> TGATCAGGAGTACATGAAG
TCCTATTTCCCTCATGAGA -> CCTATTTCCCTCATGAGAC
CCTATTGGCCCCCAATAAA -> CTATTGGCCCCCAATAAAC
TTTTGTTCTTGCAGCTCAA -> TTTGTTCTTGCAGCTCAAC
GTAGGGACCTATTGGCCCC -> TAGGGACCTATTGGCCCCC
CCTTTTAAATACTAAGGTA -> CTTTTAAATACTAAGGTAT
TTCAAAGAGAGAAACGCTT -> TCAAAGAGAGAAACGCTTC
TGGACGGCGGCGCCTTTGC -> GGACGGCGGCGCCTTTGCG
GTGAGTGGGGTGCATTAGG -> TGAGTGGGGTGCATTAGGG
AGAGTGGGGTCGCTGAGCG -> GAGTGGGGTCGCTGAGCGG
GCGGGCTTGGCTTAGCACT -> CGGGCTTGGCTTAGCACTA
TTCAGATGAACATTCGGAT -> TCAGATGAACATTCGGATA
TTCAACTACCGTGCGATGA -> TCAACTACCGTGCGATGAC
AGTACATGAAGCTCTTCCT -> GTACATGAAGCTCTTCCTA
CGACATTAAATAGACTATG -> GACATTAAATAGACTATGA
AATTCGCTGGTCAACCCAG -> ATTCGCTGGTCAACCCAGT
GTATGCGGGATGTACTAAG -> TATGCGGGATGTACTAAGG
AAGAGAGGGAGTAGGGACC -> AGAGAGGGAGTAGGGACCT
CAGCTCAACGAATGGACAC -> AGCTCAACGAATGGACACG
CAAGTGGTCAGTCTAAACA -> AAGTGGTCAGTCTAAACAC
TTGAATAAGTGGGGTGCAT -> TGAATAAGTGGGGTGCATT
CTTCTATGGCACCACAGGC -> TTCTATGGCACCACAGGCC
TTTATAAGTCCGTTATCAT -> TTATAAGTCCGTTATCATG
AACCTGCCTGTCAGATTTC -> ACCTGCCTGTCAGATTTCA
GATACAACAGTTATAGCCT -> ATACAACAGTTATAGCCTT
GCGGCGCCTTTGCGTCGTT -> CGGCGCCTTTGCGTCGTTT
CTGAAGTCCTCCCCTTTGC -> TGAAGTCCTCCCCTTTGCA
CTTACTCATGCTAGGGTAA -> TTACTCATGCTAGGGTAAG
CCACGAACCTGCCTGTCAG -> CACGAACCTGCCTGTCAGA
CGCGTTTGAAGGTCTCGTC -> GCGTTTGAAGGTCTCGTCT
GAGGGATAGCTCTTACCCG -> AGGGATAGCTCTTACCCGT
AGCTCCTTCCTAGCAAATT -> GCTCCTTCCTAGCAAATTT
GCTTAGCACTATAATGCTG -> CTTAGCACTATAATGCTGT
AGCGACATTAAATAGACTA -> GCGACATTAAATAGACTAT
GCCTGGCTCTTCTATGGCA -> CCTGGCTCTTCTATGGCAC
TAACGAAACCGACTATCTA -> AACGAAACCGACTATCTAA
CAATGGGAATTTAACGTGT -> AATGGGAATTTAACGTGTG
GAGTCGACCCATCCAGGGC -> AGTCGACCCATCCAGGGCA
CTCCTCCACAAAATGGTTT -> TCCTCCACAAAATGGTTTT
TTTGAAGGTCTCTGCGGTG -> TTGAAGGTCTCTGCGGTGC
CCCCCTCGTCTGGAACTCG -> CCCCTCGTCTGGAACTCGC
CCGTCCGTAAATGGCGACC -> CGTCCGTAAATGGCGACCT
TTGACGTCCGTCCGTAAAT -> TGACGTCCGTCCGTAAATG
AGTGTAACGAAACCGACTA -> GTGTAACGAAACCGACTAT
ATGTTATTGGAAAGAGAGG -> TGTTATTGGAAAGAGAGGG
TACAGACATGGACTCGTTA -> ACAGACATGGACTCGTTAT
TTAGAATCAGGTGGGCCTC -> TAGAATCAGGTGGGCCTCC
ACAACACGGAAATTAGATA -> CAACACGGAAATTAGATAA
GCAAGGGCAAATAGATGCG -> CAAGGGCAAATAGATGCGA
CGTCTGGAACTCGCGTTTG -> GTCTGGAACTCGCGTTTGA
CCCAATAAACGCAAGGGCA -> CCAATAAACGCAAGGGCAA
CACTTGATATGTTATTGGA -> ACTTGATATGTTATTGGAA
TCCGGCACGAGTTAGAATC -> CCGGCACGAGTTAGAATCA
TCGTCGGGCTACTATGCGC -> CGTCGGGCTACTATGCGCG
TTTCGTATGCGGGATGTAC -> TTCGTATGCGGGATGTACT
CCAATAAACGCAAGGGCAA -> CAATAAACGCAAGGGCAAA
CCTGTCAGATTTCAGATGG -> CTGTCAGATTTCAGATGGT
TCCTTTTCCGGCACGAGTT -> CCTTTTCCGGCACGAGTTA
TACGGGATGTCCTTTACCA -> ACGGGATGTCCTTTACCAG
GAGGAGATCCCTCGCGTTT -> AGGAGATCCCTCGCGTTTG
TTAAACGAATTTTGTTCTT -> TAAACGAATTTTGTTCTTG
CGGCCTTTCTCTTGTAACC -> GGCCTTTCTCTTGTAACCC
CGTTCAGCAGTCTCCAAAG -> GTTCAGCAGTCTCCAAAGC
ACCCGTCCTATGTAGAATG -> CCCGTCCTATGTAGAATGG
ACGGCTCCCGGCCTTTTAA -> CGGCTCCCGGCCTTTTAAA
CCATATTTCGGACCAACAA -> CATATTTCGGACCAACAAG
AGAGAAACGCTTCTGAAGT -> GAGAAACGCTTCTGAAGTC
CTATTTTCTTGACGTCCGT -> TATTTTCTTGACGTCCGTC
GGTAGAACCAGCCGAGATG -> GTAGAACCAGCCGAGATGA
GCGTCTGTGGGGTGCATTA -> CGTCTGTGGGGTGCATTAG
CCGATCTGCGCCGTACCGT -> CGATCTGCGCCGTACCGTA
CGTTTTCGTCGGGCTACTA -> GTTTTCGTCGGGCTACTAT
ACACTTGCGGTTTCACCGA -> CACTTGCGGTTTCACCGAG
ATATTTCGGACCAACAAGG -> TATTTCGGACCAACAAGGA
GAGTGGGGTCGCTGAGCGG -> AGTGGGGTCGCTGAGCGGG
TCCCTCGCGTTTGAAGGTC -> CCCTCGCGTTTGAAGGTCT
TGAAGGTCTCATGCGGCGT -> GAAGGTCTCATGCGGCGTC
ATTGGCCCCCAATAAACGC -> TTGGCCCCCAATAAACGCA
AATTTTGTTCTTGCAGCTC -> ATTTTGTTCTTGCAGCTCA
TCTATGGCACCACAGGCCC -> CTATGGCACCACAGGCCCT
AGTGCCGAGGAGGGATAGC -> GTGCCGAGGAGGGATAGCT
AGATCGGCACATGGCCGCC -> GATCGGCACATGGCCGCCA
GCCTTTCTCTTGTAACCCA -> CCTTTCTCTTGTAACCCAT
ATACAGGACACCGGGCTTA -> TACAGGACACCGGGCTTAC
CTGCCTGTCAGATTTCAGA -> TGCCTGTCAGATTTCAGAT
CCCCAATAAACGCAAGGGC -> CCCAATAAACGCAAGGGCA
GGTATTGGTGCTGAGATGC -> GTATTGGTGCTGAGATGCG
ATACAGAAAGGAGTGAGCT -> TACAGAAAGGAGTGAGCTC
CGGAAATTAGATAATATTA -> GGAAATTAGATAATATTAT
CCTGCTTGGCAGTCTCCAT -> CTGCTTGGCAGTCTCCATA
ATTGGAAAGAGAGGGAGTA -> TTGGAAAGAGAGGGAGTAG
CAGACACTTGCGGTTTCAC -> AGACACTTGCGGTTTCACC
AAGGGGAGTGGTGTAGGAT -> AGGGGAGTGGTGTAGGATC
ATTAGGGCTGCCTACTGAC -> TTAGGGCTGCCTACTGACT
TGCCGAGGAGGGATAGCTC -> GCCGAGGAGGGATAGCTCT
CTACCGTGCGATGACGGCT -> TACCGTGCGATGACGGCTC
CCTCGGGAGCAGCTATCTT -> CTCGGGAGCAGCTATCTTT
CTGAGCGGGCTTGGCTTAG -> TGAGCGGGCTTGGCTTAGC
GCCCCCAATAAACGCAAGG -> CCCCCAATAAACGCAAGGG
CTGCGGTGCCTTGTGGGGT -> TGCGGTGCCTTGTGGGGTG
CTCTTGTAACCCATGAACC -> TCTTGTAACCCATGAACCG
CCGCCAGACACTTGCGGTT -> CGCCAGACACTTGCGGTTT
CCAGGGTTTTCGTTCCCAA -> CAGGGTTTTCGTTCCCAAC
GAGCTTATTCGGGATTGAC -> AGCTTATTCGGGATTGACC
GAGATGCGCCAGAATTCCT -> AGATGCGCCAGAATTCCTA
TGGCACGGTCTAGTTAAAC -> GGCACGGTCTAGTTAAACG
TCCCAACAAGCTAAACTGC -> CCCAACAAGCTAAACTGCT
AAGGACATGATCAGGAGTA -> AGGACATGATCAGGAGTAC
TTTTCGTTCCCAACAAGCT -> TTTCGTTCCCAACAAGCTA
TAGACATTGGTTAGGGCCT -> AGACATTGGTTAGGGCCTA
CATGTATGCCGGAATTCAA -> ATGTATGCCGGAATTCAAC
ATGCCGGAATTCAACTACC -> TGCCGGAATTCAACTACCG
GCTTCGGCATAAACGAAGG -> CTTCGGCATAAACGAAGGC
TAAATACTAAGGTATTGGT -> AAATACTAAGGTATTGGTG
GAGACGAGCCTCGTTGCCC -> AGACGAGCCTCGTTGCCCC
TGGAAGCGTTAGGACTACC -> GGAAGCGTTAGGACTACCG
TGCATTAGGGCTGAAGATA -> GCATTAGGGCTGAAGATAC
CTCTTCTATGGCACCACAG -> TCTTCTATGGCACCACAGG
TTAGGACTACCGAGCTTAT -> TAGGACTACCGAGCTTATT
CGTGTGGAAGCCGTATGTC -> GTGTGGAAGCCGTATGTCT
GTGGTCTGTTGCACCCCCT -> TGGTCTGTTGCACCCCCTC
ATGGTGATGAACATCCCCC -> TGGTGATGAACATCCCCCT
CTCATGCTAGGGTAAGAGT -> TCATGCTAGGGTAAGAGTC
CTTATGTGAGTGGGGTGCA -> TTATGTGAGTGGGGTGCAT
ACGGCGGCGCCTTTGCGTC -> CGGCGGCGCCTTTGCGTCG
CGTTATTCAGTCGTTTCTT -> GTTATTCAGTCGTTTCTTA
ATTAAATAGACTATGATAG -> TTAAATAGACTATGATAGG
TAAACGAATTTTGTTCTTG -> AAACGAATTTTGTTCTTGC
CACAATACGTCGGGGGGTG -> ACAATACGTCGGGGGGTGC
AATAGGGAGGAGATCCCTC -> ATAGGGAGGAGATCCCTCG
AAAAAGTGTAACGAAACCG -> AAAAGTGTAACGAAACCGA
ACGCCCCTCGGGAATTGCA -> CGCCCCTCGGGAATTGCAG
TGGCTCTTCTATGGCACCA -> GGCTCTTCTATGGCACCAC
GGGAGCAGCTATCTTTGTT -> GGAGCAGCTATCTTTGTTC
CGGCATAAACGAAGGCCGG -> GGCATAAACGAAGGCCGGG
AGGGAGTCGTGTTCCCGTT -> GGGAGTCGTGTTCCCGTTT
ATTTATGATCTTTAATACG -> TTTATGATCTTTAATACGA
GGGTGCCGGTGAAATAGGG -> GGTGCCGGTGAAATAGGGA
ATTGGTGCTGAGATGCGCC -> TTGGTGCTGAGATGCGCCA
GGACACGTTGGAATTCCCT -> GACACGTTGGAATTCCCTC
GTGGTCAGTCTAAACACTT -> TGGTCAGTCTAAACACTTG
TCACTTGATATGTTATTGG -> CACTTGATATGTTATTGGA
CACTATAATGCTGTGCTTA -> ACTATAATGCTGTGCTTAT
TTCGGGATTGACCGTGGGT -> TCGGGATTGACCGTGGGTC
GATGTAGACATTGGTTAGG -> ATGTAGACATTGGTTAGGG
TGGTGCTGAGATGCGCCAG -> GGTGCTGAGATGCGCCAGA
TTCTTGACGTCCGTCCGTA -> TCTTGACGTCCGTCCGTAA
CTGTCCGCCATGATCTTGC -> TGTCCGCCATGATCTTGCC
CCAACAAGGACATGATCAG -> CAACAAGGACATGATCAGG
GGTCAGTCTAAACACTTGA -> GTCAGTCTAAACACTTGAG
CTGAAGATACAGAAAGGAG -> TGAAGATACAGAAAGGAGT
TCTTGTAACCCATGAACCG -> CTTGTAACCCATGAACCGT
AAGGCCGGGTCTCTAGTCA -> AGGCCGGGTCTCTAGTCAC
AAGTGGGGTGCATTAGGGC -> AGTGGGGTGCATTAGGGCT
ATGTAGACATTGGTTAGGG -> TGTAGACATTGGTTAGGGC
CGGAATTCAACTACCGTGC -> GGAATTCAACTACCGTGCG
AGGACATGATCAGGAGTAC -> GGACATGATCAGGAGTACA
ACGTGTGGAAGCCGTATGT -> CGTGTGGAAGCCGTATGTC
AGGCAATACAGGACACCGG -> GGCAATACAGGACACCGGG
CCTGTGGTCTGTTGCACCC -> CTGTGGTCTGTTGCACCCC
GTGCTTATGATTGCTACCG -> TGCTTATGATTGCTACCGG
GCTTACGACGCCCCTCGGG -> CTTACGACGCCCCTCGGGA
CGTGGACGGCGGCGCCTTT -> GTGGACGGCGGCGCCTTTG
GCGTTTGAAGGTCTCGTCT -> CGTTTGAAGGTCTCGTCTT
ATCCCCCTCGTCTGGAACT -> TCCCCCTCGTCTGGAACTC
AACTCCCTGTGGTCTGTTG -> ACTCCCTGTGGTCTGTTGC
GTTAAACGAATTTTGTTCT -> TTAAACGAATTTTGTTCTT
CCATTACGGGATGTCCTTT -> CATTACGGGATGTCCTTTA
TATCTTTGTTCTCAGATAA -> ATCTTTGTTCTCAGATAAG
TATGCGGGATGTACTAAGG -> ATGCGGGATGTACTAAGGG
ATCTTTGTTCTCAGATAAG -> TCTTTGTTCTCAGATAAGG
TAAATGGACGGCGTACCGA -> AAATGGACGGCGTACCGAT
AAGAGAGAAACGCTTCTGA -> AGAGAGAAACGCTTCTGAA
AAGGTATTGGTGCTGAGAT -> AGGTATTGGTGCTGAGATG
GGATAGCTCTTACCCGTCC -> GATAGCTCTTACCCGTCCT
ACATTCGGATAGCGAGAGT -> CATTCGGATAGCGAGAGTG
TTTCTCTTGTAACCCATGA -> TTCTCTTGTAACCCATGAA
GGCCGTTCCTATTTCCCTC -> GCCGTTCCTATTTCCCTCA
CCTCGCGTTTGAAGGTCTC -> CTCGCGTTTGAAGGTCTCC
TATCTAATTCACTTGATAT -> ATCTAATTCACTTGATATG
CCGTCACTGAACATCTCGC -> CGTCACTGAACATCTCGCG
GTCGTTTTCGTCGGGCTAC -> TCGTTTTCGTCGGGCTACT
CTCGGGAATTGCAGATGTA -> TCGGGAATTGCAGATGTAG
TCCCGGCCTTTTAAATACT -> CCCGGCCTTTTAAATACTA
AGGATCCTTTTCCGGCACG -> GGATCCTTTTCCGGCACGA
TCCTACAAGTGGTCAGTCT -> CCTACAAGTGGTCAGTCTA
TCCATTACGGGATGTCCTT -> CCATTACGGGATGTCCTTT
CCTCCACAAAATGGTTTTC -> CTCCACAAAATGGTTTTCG
AGTGCATCCGATGTCGGGA -> GTGCATCCGATGTCGGGAA
TCTGAAGTCCTCCCCTTTG -> CTGAAGTCCTCCCCTTTGC
AGACATTGGTTAGGGCCTA -> GACATTGGTTAGGGCCTAC
CATGCTAGGGTAAGAGTCC -> ATGCTAGGGTAAGAGTCCA
AGAGAGGGAGTAGGGACCT -> GAGAGGGAGTAGGGACCTA
ACTATGATAGGCGTAGTGC -> CTATGATAGGCGTAGTGCA
TCTCGCGTTTGAAGGTCTC -> CTCGCGTTTGAAGGTCTCT
GTTTCACCGAGTGCCGAGG -> TTTCACCGAGTGCCGAGGA
AGGTCTCTGCGGTGCCTTG -> GGTCTCTGCGGTGCCTTGT
GCGGGATGTACTAAGGGAG -> CGGGATGTACTAAGGGAGT
GCCTTTGCGTCGTTTTCGT -> CCTTTGCGTCGTTTTCGTC
GTCAGTCAATGGGAATTTA -> TCAGTCAATGGGAATTTAA
TGCATCCGTATTAACGAAA -> GCATCCGTATTAACGAAAT
GTCGTGTTCCCGTTTATGC -> TCGTGTTCCCGTTTATGCG
ATGGTTTTCGTATGCGGGA -> TGGTTTTCGTATGCGGGAT
GGGATGTCCTTTACCAGGG -> GGATGTCCTTTACCAGGGT
GTCGACCCATCCAGGGCAT -> TCGACCCATCCAGGGCATT
TACAAGTGGTCAGTCTAAA -> ACAAGTGGTCAGTCTAAAC
CTTCGGCATAAACGAAGGC -> TTCGGCATAAACGAAGGCC
GGGCTGCCTAATTCGCTGG -> GGCTGCCTAATTCGCTGGT
GCGTTTGAAGGTCTCTGCG -> CGTTTGAAGGTCTCTGCGG
TACCCGTCCTATGTAGAAT -> ACCCGTCCTATGTAGAATG
AGGACACCGGGCTTACGAC -> GGACACCGGGCTTACGACG
CGGGCTTACGACGCCCCTC -> GGGCTTACGACGCCCCTCG
ACATTGGTTAGGGCCTACC -> CATTGGTTAGGGCCTACCC
TCCTCCCCTTTGCATCGAA -> CCTCCCCTTTGCATCGAAT
TAGGTGTTCCTATTTATGA -> AGGTGTTCCTATTTATGAT
CTATAATGCTGTGCTTATG -> TATAATGCTGTGCTTATGA
TGGTGTAGGATCCTTTTCC -> GGTGTAGGATCCTTTTCCG
GCTGGTGCTTACTCATGCT -> CTGGTGCTTACTCATGCTA
ATGCGGCGTCTGTGGGGTG -> TGCGGCGTCTGTGGGGTGC
GCCGTTCCTATTTCCCTCA -> CCGTTCCTATTTCCCTCAT
AGCTAAACTGCTTCGGCAT -> GCTAAACTGCTTCGGCATA
CAGTCTCCATATTTCGGAC -> AGTCTCCATATTTCGGACC
GGGCCCCATGCTACGTTTA -> GGCCCCATGCTACGTTTAA
TATGGCACCACAGGCCCTG -> ATGGCACCACAGGCCCTGT
ACCGGGCTTACGACGCCCC -> CCGGGCTTACGACGCCCCT
GGGAGGAGATCCCTCGCGT -> GGAGGAGATCCCTCGCGTT
TGCGGGATGTACTAAGGGA -> GCGGGATGTACTAAGGGAG
ACGTTAGGTGTTCCTATTT -> CGTTAGGTGTTCCTATTTA
AGGAGGGCCCCATGCTACG -> GGAGGGCCCCATGCTACGT
TCAGATTTCAGATGGTGAT -> CAGATTTCAGATGGTGATG
CCATGCTACGTTTAATAGC -> CATGCTACGTTTAATAGCA
TATAAGTCCGTTATCATGG -> ATAAGTCCGTTATCATGGA
ACTCATGCTAGGGTAAGAG -> CTCATGCTAGGGTAAGAGT
GTCTACCTCCGTCACTGAA -> TCTACCTCCGTCACTGAAC
ACTGAACATCTCGCGTTTG -> CTGAACATCTCGCGTTTGA
TTTTCGTATGCGGGATGTA -> TTTCGTATGCGGGATGTAC
TTTTAAATACTAAGGTATT -> TTTAAATACTAAGGTATTG
TAATGCTGTGCTTATGATT -> AATGCTGTGCTTATGATTG
ACCCCCTCGTCTATTAGAG -> CCCCCTCGTCTATTAGAGG
TCTATCTGTTGACCCGTGG -> CTATCTGTTGACCCGTGGA
CTAAACACTTGAGGGTAGA -> TAAACACTTGAGGGTAGAA
TCGAGGCAATACAGGACAC -> CGAGGCAATACAGGACACC
GACATGGCACGGTCTAGTT -> ACATGGCACGGTCTAGTTA
GATGCGCCAGAATTCCTAC -> ATGCGCCAGAATTCCTACA
GTCTCTGCGGTGCCTTGTG -> TCTCTGCGGTGCCTTGTGG
AATCAAAGTCGGCCTTTCT -> ATCAAAGTCGGCCTTTCTC
CGTTGCCCCCCCATCATGT -> GTTGCCCCCCCATCATGTA
TCCCTCATGAGACGAGCCT -> CCCTCATGAGACGAGCCTC
TCGGATAGCGAGAGTGGGG -> CGGATAGCGAGAGTGGGGT
TTGAAGGTCTCGTCTTATG -> TGAAGGTCTCGTCTTATGT
TTTATGCGACATCGATCGC -> TTATGCGACATCGATCGCC
GGTGCATTAGGGCTGCATC -> GTGCATTAGGGCTGCATCC
AGTTCAGCGACATTAAATA -> GTTCAGCGACATTAAATAG
CTGAACATCTCGCGTTTGA -> TGAACATCTCGCGTTTGAA
TTCTTATTCCATTCAGATG -> TCTTATTCCATTCAGATGA
GTCTCCATATTTCGGACCA -> TCTCCATATTTCGGACCAA
ACCGAGCTTATTCGGGATT -> CCGAGCTTATTCGGGATTG
TCCCTCGAGGCAATACAGG -> CCCTCGAGGCAATACAGGA
CATGATCAGGAGTACATGA -> ATGATCAGGAGTACATGAA
AGATGGAGTCGACCCATCC -> GATGGAGTCGACCCATCCA
GAGTGCCGAGGAGGGATAG -> AGTGCCGAGGAGGGATAGC
AAACCGACTATCTAATTCA -> AACCGACTATCTAATTCAC
CGCAAGGGCAAATAGATGC -> GCAAGGGCAAATAGATGCG
ATGATTGCTACCGGAACAT -> TGATTGCTACCGGAACATC
AACATCCCCCTCGTCTGGA -> ACATCCCCCTCGTCTGGAA
TGGTTAGGGCCTACCCGTT -> GGTTAGGGCCTACCCGTTC
GGCTGCCTAATTCGCTGGT -> GCTGCCTAATTCGCTGGTC
ACCTCGGGAGCAGCTATCT -> CCTCGGGAGCAGCTATCTT
AAATAGACTATGATAGGCG -> AATAGACTATGATAGGCGT
ATGCGACATCGATCGCCTG -> TGCGACATCGATCGCCTGG
CCGTTTATGCGACATCGAT -> CGTTTATGCGACATCGATC
GGAGATCCCTCGCGTTTGA -> GAGATCCCTCGCGTTTGAA
GTCACTGAACATCTCGCGT -> TCACTGAACATCTCGCGTT
GATTTCAGATGGTGATGAA -> ATTTCAGATGGTGATGAAC
ACCTCCGTCACTGAACATC -> CCTCCGTCACTGAACATCT
AGTCAGTGCCCAAACCGTC -> GTCAGTGCCCAAACCGTCA
CCGAGCTTATTCGGGATTG -> CGAGCTTATTCGGGATTGA
CGTAGTGCATCCGATGTCG -> GTAGTGCATCCGATGTCGG
GATAAGGGGAGTGGTGTAG -> ATAAGGGGAGTGGTGTAGG
ACATCGCATTTATAAGTCC -> CATCGCATTTATAAGTCCG
TACTCATGCTAGGGTAAGA -> ACTCATGCTAGGGTAAGAG
TGCGGTGCCTTGTGGGGTG -> GCGGTGCCTTGTGGGGTGC
TTTTCTTGACGTCCGTCCG -> TTTCTTGACGTCCGTCCGT
AGGGTAGAACCAGCCGAGA -> GGGTAGAACCAGCCGAGAT
CAGGGTGGTCAGTCAATGG -> AGGGTGGTCAGTCAATGGG
ACCGTACCGGTTTAAGCTC -> CCGTACCGGTTTAAGCTCC
ACAACAGTTATAGCCTTTA -> CAACAGTTATAGCCTTTAC
GCTGAGATGCGCCAGAATT -> CTGAGATGCGCCAGAATTC
GTCTAAACACTTGAGGGTA -> TCTAAACACTTGAGGGTAG
TAGGGCTGCCTAATTCGCT -> AGGGCTGCCTAATTCGCTG
ACGATACAACAGTTATAGC -> CGATACAACAGTTATAGCC
AGAGTCCATTACGGGATGT -> GAGTCCATTACGGGATGTC
GCTCGCGTTTGAAGGTCTC -> CTCGCGTTTGAAGGTCTCG
AAGGTCTCTGCGGTGCCTT -> AGGTCTCTGCGGTGCCTTG
CGCCCCTCGGGAATTGCAG -> GCCCCTCGGGAATTGCAGA
TTAGGGCTGAAGATACAGA -> TAGGGCTGAAGATACAGAA
AGTGGTCAGTCTAAACACT -> GTGGTCAGTCTAAACACTT
ACGAAATACACAGACTATT -> CGAAATACACAGACTATTT
CTCTTACCCGTCCTATGTA -> TCTTACCCGTCCTATGTAG
GGAATTCAACTACCGTGCG -> GAATTCAACTACCGTGCGA
GCTATCTTTGTTCTCAGAT -> CTATCTTTGTTCTCAGATA
CGTCAGGGTGGTCAGTCAA -> GTCAGGGTGGTCAGTCAAT
TATTGGCCCCCAATAAACG -> ATTGGCCCCCAATAAACGC
CAGGTGGGCCTCCTCCACA -> AGGTGGGCCTCCTCCACAA
GACGCCCCTCGGGAATTGC -> ACGCCCCTCGGGAATTGCA
GCTAAACTGCTTCGGCATA -> CTAAACTGCTTCGGCATAA
GGAACATCGCATTTATAAG -> GAACATCGCATTTATAAGT
CGCTGGTCAACCCAGTCAG -> GCTGGTCAACCCAGTCAGT
ATGTCTACCTCCGTCACTG -> TGTCTACCTCCGTCACTGA
TTGAAGGTCTCATGCGGCG -> TGAAGGTCTCATGCGGCGT
ATTCCATTCAGATGAACAT -> TTCCATTCAGATGAACATT
CGTGTTCCCGTTTATGCGA -> GTGTTCCCGTTTATGCGAC
TCTTGACGTCCGTCCGTAA -> CTTGACGTCCGTCCGTAAA
GGGCCTACCCGTTCAGCAG -> GGCCTACCCGTTCAGCAGT
GCTGCATCCGTATTAACGA -> CTGCATCCGTATTAACGAA
GCCTCGTTGCCCCCCCATC -> CCTCGTTGCCCCCCCATCA
AGACACTTGCGGTTTCACC -> GACACTTGCGGTTTCACCG
TGGAGTCGACCCATCCAGG -> GGAGTCGACCCATCCAGGG
CTATGGCACCACAGGCCCT -> TATGGCACCACAGGCCCTG
GATCGCCTGGCTCTTCTAT -> ATCGCCTGGCTCTTCTATG
GGATTGACCGTGGGTCGCA -> GATTGACCGTGGGTCGCAT
TGATTGCTACCGGAACATC -> GATTGCTACCGGAACATCG
CTCCCCTTTGCATCGAATC -> TCCCCTTTGCATCGAATCA
GGAAGCGTTAGGACTACCG -> GAAGCGTTAGGACTACCGA
GTCGGGGGTCCGCTTCACA -> TCGGGGGTCCGCTTCACAG
CGGTGCCTTGTGGGGTGCA -> GGTGCCTTGTGGGGTGCAT
TCAAAGAGAGAAACGCTTC -> CAAAGAGAGAAACGCTTCT
GAATTCAACTACCGTGCGA -> AATTCAACTACCGTGCGAT
ACCGACTATCTAATTCACT -> CCGACTATCTAATTCACTT
TGCATTAGGGCTGCATCCG -> GCATTAGGGCTGCATCCGT
ATGAACATCCCCCTCGTCT -> TGAACATCCCCCTCGTCTG
ATGTATGCCGGAATTCAAC -> TGTATGCCGGAATTCAACT
CGACATCGATCGCCTGGCT -> GACATCGATCGCCTGGCTC
GACACGTTGGAATTCCCTC -> ACACGTTGGAATTCCCTCG
TTAGGTGTTCCTATTTATG -> TAGGTGTTCCTATTTATGA
GCCGGTGAAATAGGGAGGA -> CCGGTGAAATAGGGAGGAG
CCTCGGGAATTGCAGATGT -> CTCGGGAATTGCAGATGTA
TACCCGTTCAGCAGTCTCC -> ACCCGTTCAGCAGTCTCCA
GTCAATGGGAATTTAACGT -> TCAATGGGAATTTAACGTG
TACCTCCGTCACTGAACAT -> ACCTCCGTCACTGAACATC
ATGTAGAATGGCTGGCCGT -> TGTAGAATGGCTGGCCGTT
GACCCAGGAGGGCCCCATG -> ACCCAGGAGGGCCCCATGC
CACAGAATATCACAATACG -> ACAGAATATCACAATACGT
AAAGTCGGCCTTTCTCTTG -> AAGTCGGCCTTTCTCTTGT
ATTCAACTACCGTGCGATG -> TTCAACTACCGTGCGATGA
CTCGTCTATTAGAGGTCGT -> TCGTCTATTAGAGGTCGTA
GATAGGCGTAGTGCATCCG -> ATAGGCGTAGTGCATCCGA
GAATTGCAGATGTAGACAT -> AATTGCAGATGTAGACATT
GAGCTGACGGCTGGTGCTT -> AGCTGACGGCTGGTGCTTA
TACTAAGGTATTGGTGCTG -> ACTAAGGTATTGGTGCTGA
TTTGAAGGTCTCCCGTTGA -> TTGAAGGTCTCCCGTTGAA
GTCTCCCGTTGAATAAGTG -> TCTCCCGTTGAATAAGTGG
TTCTTTAAATGGACGGCGT -> TCTTTAAATGGACGGCGTA
ATACTAAGGTATTGGTGCT -> TACTAAGGTATTGGTGCTG
GTCTATCTGTTGACCCGTG -> TCTATCTGTTGACCCGTGG
CTTCACAGAATATCACAAT -> TTCACAGAATATCACAATA
GTCTCGTCTTATGTGAGTG -> TCTCGTCTTATGTGAGTGG
GCGACATCGATCGCCTGGC -> CGACATCGATCGCCTGGCT
GAACATCCCCCTCGTCTGG -> AACATCCCCCTCGTCTGGA
CAACCCAGTCAGTGCCCAA -> AACCCAGTCAGTGCCCAAA
CCTTCCTAGCAAATTTTGG -> CTTCCTAGCAAATTTTGGC
GTAACTCCTGTCAGTTCAG -> TAACTCCTGTCAGTTCAGC
GGGGAGTGGTGTAGGATCC -> GGGAGTGGTGTAGGATCCT
CCGTTATCATGGAGCTGAC -> CGTTATCATGGAGCTGACG
TGAACCGTACCGGTTTAAG -> GAACCGTACCGGTTTAAGC
TAATTACTGGCCGTTCCGT -> AATTACTGGCCGTTCCGTA
GGCTGGCCGTTCCTATTTC -> GCTGGCCGTTCCTATTTCC
GAAGCCGTATGTCTACCTC -> AAGCCGTATGTCTACCTCC
GTGTAACGAAACCGACTAT -> TGTAACGAAACCGACTATC
CGAAATACGAGATCGGCAC -> GAAATACGAGATCGGCACA
TACCGGTTTAAGCTCCTTC -> ACCGGTTTAAGCTCCTTCC
GTTTCTTATTCCATTCAGA -> TTTCTTATTCCATTCAGAT
GCACGGTCTAGTTAAACGA -> CACGGTCTAGTTAAACGAA
GGCACATGGCCGCCAGACA -> GCACATGGCCGCCAGACAC
GAATCAGGTGGGCCTCCTC -> AATCAGGTGGGCCTCCTCC
ACATTAAATAGACTATGAT -> CATTAAATAGACTATGATA
AAGCTCTTCCTAGACATGG -> AGCTCTTCCTAGACATGGC
CCCTCATGAGACGAGCCTC -> CCTCATGAGACGAGCCTCG
TTCACAGAATATCACAATA -> TCACAGAATATCACAATAC
TTCCCAACAAGCTAAACTG -> TCCCAACAAGCTAAACTGC
ATAAGTGGGGTGCATTAGG -> TAAGTGGGGTGCATTAGGG
TGCCTAATTCGCTGGTCAA -> GCCTAATTCGCTGGTCAAC
GCCCCTCGGGAATTGCAGA -> CCCCTCGGGAATTGCAGAT
GTTCCCGTTTATGCGACAT -> TTCCCGTTTATGCGACATC
CCCCCAATAAACGCAAGGG -> CCCCAATAAACGCAAGGGC
TTCCATTCAGATGAACATT -> TCCATTCAGATGAACATTC
TTCGAGAGTGTAGCTGAGT -> TCGAGAGTGTAGCTGAGTA
AGGGACCTATTGGCCCCCA -> GGGACCTATTGGCCCCCAA
TCCAGGGCATTCCCTGCTT -> CCAGGGCATTCCCTGCTTG
CCTACAAGTGGTCAGTCTA -> CTACAAGTGGTCAGTCTAA
GCGTACCGATCTGCGCCGT -> CGTACCGATCTGCGCCGTA
AAGGAGTGAGCTCGCGTTT -> AGGAGTGAGCTCGCGTTTG
CTTTTCCGGCACGAGTTAG -> TTTTCCGGCACGAGTTAGA
TTAGGGCTGCATCCGTATT -> TAGGGCTGCATCCGTATTA
TCTGTGGGGTGCATTAGGG -> CTGTGGGGTGCATTAGGGC
AAAGAGAGGGAGTAGGGAC -> AAGAGAGGGAGTAGGGACC
AAGGGCAAATAGATGCGAA -> AGGGCAAATAGATGCGAAA
CTATCTGTTGACCCGTGGA -> TATCTGTTGACCCGTGGAC
GGTCGTACAGACATGGACT -> GTCGTACAGACATGGACTC
TAGATTCTTTAAATGGACG -> AGATTCTTTAAATGGACGG
CAAGGGCAAATAGATGCGA -> AAGGGCAAATAGATGCGAA
TAGCACGCTGTCGTCGGGG -> AGCACGCTGTCGTCGGGGG
CGTCTATCTGTTGACCCGT -> GTCTATCTGTTGACCCGTG
GTCAGTCTAAACACTTGAG -> TCAGTCTAAACACTTGAGG
CTTATGATTGCTACCGGAA -> TTATGATTGCTACCGGAAC
TTTAAGCTCCTTCCTAGCA -> TTAAGCTCCTTCCTAGCAA
CTGTGCTTATGATTGCTAC -> TGTGCTTATGATTGCTACC
TTAATTACTGGCCGTTCCG -> TAATTACTGGCCGTTCCGT
CAGATGGTGATGAACATCC -> AGATGGTGATGAACATCCC
TGACGGCTCCCGGCCTTTT -> GACGGCTCCCGGCCTTTTA
CGTTTGAAGGTCTCATGCG -> GTTTGAAGGTCTCATGCGG
TACTTCGAGAGTGTAGCTG -> ACTTCGAGAGTGTAGCTGA
CATTAGGGCTGCCTAATTC -> ATTAGGGCTGCCTAATTCG
TGATGAACATCCCCCTCGT -> GATGAACATCCCCCTCGTC
TGTGGTCTGTTGCACCCCC -> GTGGTCTGTTGCACCCCCT
TACTGACTGTCCGCCATGA -> ACTGACTGTCCGCCATGAT
AATGGACACGTTGGAATTC -> ATGGACACGTTGGAATTCC
AGAGGGAGTAGGGACCTAT -> GAGGGAGTAGGGACCTATT
CGAGTGCCGAGGAGGGATA -> GAGTGCCGAGGAGGGATAG
CGGCGGCGCCTTTGCGTCG -> GGCGGCGCCTTTGCGTCGT
GGTTTAAGCTCCTTCCTAG -> GTTTAAGCTCCTTCCTAGC
CTGTTGCACCCCCTCGTCT -> TGTTGCACCCCCTCGTCTA
TAAGTCCGTTATCATGGAG -> AAGTCCGTTATCATGGAGC
TGGCTGGCCGTTCCTATTT -> GGCTGGCCGTTCCTATTTC
TGTTCCCGTTTATGCGACA -> GTTCCCGTTTATGCGACAT
TTGACCCGTGGACGGCGGC -> TGACCCGTGGACGGCGGCG
CCAGAATTCCTACAAGTGG -> CAGAATTCCTACAAGTGGT
GTGCTGAGATGCGCCAGAA -> TGCTGAGATGCGCCAGAAT
CTGCATCCGTATTAACGAA -> TGCATCCGTATTAACGAAA
GATACAGAAAGGAGTGAGC -> ATACAGAAAGGAGTGAGCT
CCGCCATGATCTTGCCACG -> CGCCATGATCTTGCCACGA
CATGGCACGGTCTAGTTAA -> ATGGCACGGTCTAGTTAAA
GGGTCCGCTTCACAGAATA -> GGTCCGCTTCACAGAATAT
GTCTGGAACTCGCGTTTGA -> TCTGGAACTCGCGTTTGAA
TAAGAGTCCATTACGGGAT -> AAGAGTCCATTACGGGATG
CCGTCCTATGTAGAATGGC -> CGTCCTATGTAGAATGGCT
ATACGTCGGGGGGTGCCGG -> TACGTCGGGGGGTGCCGGT
GATTCTTTAAATGGACGGC -> ATTCTTTAAATGGACGGCG
GCCGGGTCTCTAGTCACGA -> CCGGGTCTCTAGTCACGAA
AATTCACTTGATATGTTAT -> ATTCACTTGATATGTTATT
GAGACAGGTTAATTACTGG -> AGACAGGTTAATTACTGGC
TCGTCTATTAGAGGTCGTA -> CGTCTATTAGAGGTCGTAC
CGCTTCACAGAATATCACA -> GCTTCACAGAATATCACAA
ATGGAGCTGACGGCTGGTG -> TGGAGCTGACGGCTGGTGC
TAGATAATATTATCAGCCG -> AGATAATATTATCAGCCGA
GCCTAATTCGCTGGTCAAC -> CCTAATTCGCTGGTCAACC
GCTACCGGAACATCGCATT -> CTACCGGAACATCGCATTT
CCGGAACATCGCATTTATA -> CGGAACATCGCATTTATAA
GTCGGGCTACTATGCGCGG -> TCGGGCTACTATGCGCGGT
CTTGTAACCCATGAACCGT -> TTGTAACCCATGAACCGTA
CTAAACTGCTTCGGCATAA -> TAAACTGCTTCGGCATAAA
ATGGAAGCGTTAGGACTAC -> TGGAAGCGTTAGGACTACC
ATGATCTTGCCACGAACCT -> TGATCTTGCCACGAACCTG
GGTTTCACCGAGTGCCGAG -> GTTTCACCGAGTGCCGAGG
GTGGGGTGCATTAGGGCTG -> TGGGGTGCATTAGGGCTGC,TGGGGTGCATTAGGGCTGC,TGGGGTGCATTAGGGCTGA,TGGGGTGCATTAGGGCTGC
TATTCAGTCGTTTCTTATT -> ATTCAGTCGTTTCTTATTC
GGATGTCCTTTACCAGGGT -> GATGTCCTTTACCAGGGTT
TTCACCGAGTGCCGAGGAG -> TCACCGAGTGCCGAGGAGG
ACAATACGTCGGGGGGTGC -> CAATACGTCGGGGGGTGCC
TGGCTTAGCACTATAATGC -> GGCTTAGCACTATAATGCT
GGCGGCGCCTTTGCGTCGT -> GCGGCGCCTTTGCGTCGTT
TAACTCCTGTCAGTTCAGC -> AACTCCTGTCAGTTCAGCG
GCCCTGTGGTGGTAAAAAG -> CCCTGTGGTGGTAAAAAGT
ATGATAGGCGTAGTGCATC -> TGATAGGCGTAGTGCATCC
GTGCGATGACGGCTCCCGG -> TGCGATGACGGCTCCCGGC
ATGACGGCTCCCGGCCTTT -> TGACGGCTCCCGGCCTTTT
AGAGGTCGTACAGACATGG -> GAGGTCGTACAGACATGGA
TCAGATGAACATTCGGATA -> CAGATGAACATTCGGATAG
AAACGAATTTTGTTCTTGC -> AACGAATTTTGTTCTTGCA
TTAAATACTAAGGTATTGG -> TAAATACTAAGGTATTGGT
CCTTGTGGGGTGCATTAGG -> CTTGTGGGGTGCATTAGGG
CAGCTATCTTTGTTCTCAG -> AGCTATCTTTGTTCTCAGA
ATGCGCGGTCACGTTAGGT -> TGCGCGGTCACGTTAGGTG
CGGCACGAGTTAGAATCAG -> GGCACGAGTTAGAATCAGG
ATGCTGTGCTTATGATTGC -> TGCTGTGCTTATGATTGCT
GACATTAAATAGACTATGA -> ACATTAAATAGACTATGAT
GATGAACATTCGGATAGCG -> ATGAACATTCGGATAGCGA
AAGTCCTCCCCTTTGCATC -> AGTCCTCCCCTTTGCATCG
AGAACCAGCCGAGATGAGA -> GAACCAGCCGAGATGAGAC
CTGGTCAACCCAGTCAGTG -> TGGTCAACCCAGTCAGTGC
GAAGCTCTTCCTAGACATG -> AAGCTCTTCCTAGACATGG
TGAAGGTCTCGTCTTATGT -> GAAGGTCTCGTCTTATGTG
GGAGTCGTGTTCCCGTTTA -> GAGTCGTGTTCCCGTTTAT
TTTAAATGGACGGCGTACC -> TTAAATGGACGGCGTACCG
AACCCAGTCAGTGCCCAAA -> ACCCAGTCAGTGCCCAAAC
CCATGAACCGTACCGGTTT -> CATGAACCGTACCGGTTTA
ACAAGTGGTCAGTCTAAAC -> CAAGTGGTCAGTCTAAACA
CGTTTGAAGGTCTCGTCTT -> GTTTGAAGGTCTCGTCTTA
CTCGTTATTCAGTCGTTTC -> TCGTTATTCAGTCGTTTCT
ATACAACAGTTATAGCCTT -> TACAACAGTTATAGCCTTT
TAAATAGACTATGATAGGC -> AAATAGACTATGATAGGCG
TCTTCCTAGACATGGCACG -> CTTCCTAGACATGGCACGG
CAGGACACCGGGCTTACGA -> AGGACACCGGGCTTACGAC
TTATGCGACATCGATCGCC -> TATGCGACATCGATCGCCT
GGGGTCCGCTTCACAGAAT -> GGGTCCGCTTCACAGAATA
ATTATCAGCCGACCCAGGA -> TTATCAGCCGACCCAGGAG
CATTAAATAGACTATGATA -> ATTAAATAGACTATGATAG
GGTGCCTTGTGGGGTGCAT -> GTGCCTTGTGGGGTGCATT
GGAGTGAGCTCGCGTTTGA -> GAGTGAGCTCGCGTTTGAA
CTTGCGGTTTCACCGAGTG -> TTGCGGTTTCACCGAGTGC
AAGGGAGTCGTGTTCCCGT -> AGGGAGTCGTGTTCCCGTT
ATGTACTAAGGGAGTCGTG -> TGTACTAAGGGAGTCGTGT
ACCACAGGCCCTGTGGTGG -> CCACAGGCCCTGTGGTGGT
AAATACGAGATCGGCACAT -> AATACGAGATCGGCACATG
ATGATCTTTAATACGATAC -> TGATCTTTAATACGATACA
CGTCCGTAAATGGCGACCT -> GTCCGTAAATGGCGACCTC
GACCCGTGGACGGCGGCGC -> ACCCGTGGACGGCGGCGCC
CTTGATATGTTATTGGAAA -> TTGATATGTTATTGGAAAG
TACTATGCGCGGTCACGTT -> ACTATGCGCGGTCACGTTA
TAATAGCACGCTGTCGTCG -> AATAGCACGCTGTCGTCGG
TGACCCGTGGACGGCGGCG -> GACCCGTGGACGGCGGCGC
CTATCTAATTCACTTGATA -> TATCTAATTCACTTGATAT
CTGGCCGTTCCGTATTTTT -> TGGCCGTTCCGTATTTTTG
TTTTGAAGATGGAGTCGAC -> TTTGAAGATGGAGTCGACC
ATAATGCTGTGCTTATGAT -> TAATGCTGTGCTTATGATT
CCTCGTCTATTAGAGGTCG -> CTCGTCTATTAGAGGTCGT
CGCCTTTGCGTCGTTTTCG -> GCCTTTGCGTCGTTTTCGT
TCAATGGGAATTTAACGTG -> CAATGGGAATTTAACGTGT
CGAGCCTCGTTGCCCCCCC -> GAGCCTCGTTGCCCCCCCA
TGCGCCAGAATTCCTACAA -> GCGCCAGAATTCCTACAAG
ATCATGGAGCTGACGGCTG -> TCATGGAGCTGACGGCTGG
CGGCTGGTGCTTACTCATG -> GGCTGGTGCTTACTCATGC
CTCTAGTCACGAACCAAAC -> TCTAGTCACGAACCAAACA
GAAACGCTTCTGAAGTCCT -> AAACGCTTCTGAAGTCCTC
AGGTATTGGTGCTGAGATG -> GGTATTGGTGCTGAGATGC
TAAACGCAAGGGCAAATAG -> AAACGCAAGGGCAAATAGA
CATGGCCGCCAGACACTTG -> ATGGCCGCCAGACACTTGC
CCAAACCGTCAGGGTGGTC -> CAAACCGTCAGGGTGGTCA
GAGTCGTGTTCCCGTTTAT -> AGTCGTGTTCCCGTTTATG
ATTACTGGCCGTTCCGTAT -> TTACTGGCCGTTCCGTATT
CATAAACGAAGGCCGGGTC -> ATAAACGAAGGCCGGGTCT
GCCGGAATTCAACTACCGT -> CCGGAATTCAACTACCGTG
GATGTCCTTTACCAGGGTT -> ATGTCCTTTACCAGGGTTT
AGTGGGGTGCATTAGGGCT -> GTGGGGTGCATTAGGGCTG,GTGGGGTGCATTAGGGCTG
TCCTGTCAGTTCAGCGACA -> CCTGTCAGTTCAGCGACAT
GAATCAAAGTCGGCCTTTC -> AATCAAAGTCGGCCTTTCT
CCGTCAGGGTGGTCAGTCA -> CGTCAGGGTGGTCAGTCAA
ACCCGTTCAGCAGTCTCCA -> CCCGTTCAGCAGTCTCCAA
AGCGAGAGTGGGGTCGCTG -> GCGAGAGTGGGGTCGCTGA
ATAGGCGTAGTGCATCCGA -> TAGGCGTAGTGCATCCGAT
ACGAACCAAACAACACGGA -> CGAACCAAACAACACGGAA
CGGGGGGTGCCGGTGAAAT -> GGGGGGTGCCGGTGAAATA
TCAACTACCGTGCGATGAC -> CAACTACCGTGCGATGACG
TTAGGGCTGCCTACTGACT -> TAGGGCTGCCTACTGACTG
GAGTAGGGACCTATTGGCC -> AGTAGGGACCTATTGGCCC
TTTAATACGATACAACAGT -> TTAATACGATACAACAGTT
TCCACAAAATGGTTTTCGT -> CCACAAAATGGTTTTCGTA
CAGTGCCCAAACCGTCAGG -> AGTGCCCAAACCGTCAGGG
GAGGTCGTACAGACATGGA -> AGGTCGTACAGACATGGAC
AGATAAGGGGAGTGGTGTA -> GATAAGGGGAGTGGTGTAG
CCGTTCCTATTTCCCTCAT -> CGTTCCTATTTCCCTCATG
TGTCCTTTACCAGGGTTTT -> GTCCTTTACCAGGGTTTTC
AACTATGGAAGCGTTAGGA -> ACTATGGAAGCGTTAGGAC
ATCTCGCGTTTGAAGGTCT -> TCTCGCGTTTGAAGGTCTC
GGGCCTCCTCCACAAAATG -> GGCCTCCTCCACAAAATGG
CCGGGTCTCTAGTCACGAA -> CGGGTCTCTAGTCACGAAC
ATGAACATTCGGATAGCGA -> TGAACATTCGGATAGCGAG
TCTCTAGTCACGAACCAAA -> CTCTAGTCACGAACCAAAC
TGGTCAACCCAGTCAGTGC -> GGTCAACCCAGTCAGTGCC
TCGTCTGGAACTCGCGTTT -> CGTCTGGAACTCGCGTTTG
ATCCCTCGCGTTTGAAGGT -> TCCCTCGCGTTTGAAGGTC
GTAACCCATGAACCGTACC -> TAACCCATGAACCGTACCG
CCCAAACCGTCAGGGTGGT -> CCAAACCGTCAGGGTGGTC
CCGTAAATGGCGACCTCGG -> CGTAAATGGCGACCTCGGG
TTTGAAGGTCTCATGCGGC -> TTGAAGGTCTCATGCGGCG
GGGACCTATTGGCCCCCAA -> GGACCTATTGGCCCCCAAT
CGGGATGTACTAAGGGAGT -> GGGATGTACTAAGGGAGTC
GCACGCTGTCGTCGGGGGT -> CACGCTGTCGTCGGGGGTC
CATTAGGGCTGCCTACTGA -> ATTAGGGCTGCCTACTGAC
ACCCATGAACCGTACCGGT -> CCCATGAACCGTACCGGTT
ATTCCCTGCTTGGCAGTCT -> TTCCCTGCTTGGCAGTCTC
GGGTAAGAGTCCATTACGG -> GGTAAGAGTCCATTACGGG
CGCGGTCACGTTAGGTGTT -> GCGGTCACGTTAGGTGTTC
CGGGCTTGGCTTAGCACTA -> GGGCTTGGCTTAGCACTAT
ACTATGGAAGCGTTAGGAC -> CTATGGAAGCGTTAGGACT
AGGGAGTAGGGACCTATTG -> GGGAGTAGGGACCTATTGG
GTTGACCCGTGGACGGCGG -> TTGACCCGTGGACGGCGGC
CTTCTGAAGTCCTCCCCTT -> TTCTGAAGTCCTCCCCTTT
GTCGTTTCTTATTCCATTC -> TCGTTTCTTATTCCATTCA
CGTTCCCAACAAGCTAAAC -> GTTCCCAACAAGCTAAACT
TCGGCATAAACGAAGGCCG -> CGGCATAAACGAAGGCCGG
CAAGGACATGATCAGGAGT -> AAGGACATGATCAGGAGTA
ACAAAATGGTTTTCGTATG -> CAAAATGGTTTTCGTATGC
GGGAGTAGGGACCTATTGG -> GGAGTAGGGACCTATTGGC
GTAAATGGCGACCTCGGGA -> TAAATGGCGACCTCGGGAG
AAACACTTGAGGGTAGAAC -> AACACTTGAGGGTAGAACC
AATGGACGGCGTACCGATC -> ATGGACGGCGTACCGATCT
TGGACGGCGTACCGATCTG -> GGACGGCGTACCGATCTGC
CTGTCAGTTCAGCGACATT -> TGTCAGTTCAGCGACATTA
CCTAGACATGGCACGGTCT -> CTAGACATGGCACGGTCTA
AACCCATGAACCGTACCGG -> ACCCATGAACCGTACCGGT
TTCCTACAAGTGGTCAGTC -> TCCTACAAGTGGTCAGTCT
AACCGACTATCTAATTCAC -> ACCGACTATCTAATTCACT
AGGCCGGGTCTCTAGTCAC -> GGCCGGGTCTCTAGTCACG
TGATAGGCGTAGTGCATCC -> GATAGGCGTAGTGCATCCG
CCCTCGTCTGGAACTCGCG -> CCTCGTCTGGAACTCGCGT
AACGCTTCTGAAGTCCTCC -> ACGCTTCTGAAGTCCTCCC
ATGGCGACCTCGGGAGCAG -> TGGCGACCTCGGGAGCAGC
AAACGAAGGCCGGGTCTCT -> AACGAAGGCCGGGTCTCTA
TGCCCAAACCGTCAGGGTG -> GCCCAAACCGTCAGGGTGG
GGAAAGAGAGGGAGTAGGG -> GAAAGAGAGGGAGTAGGGA
CTGCTTCGGCATAAACGAA -> TGCTTCGGCATAAACGAAG
CCTCGTTGCCCCCCCATCA -> CTCGTTGCCCCCCCATCAT
TAGGGACCTATTGGCCCCC -> AGGGACCTATTGGCCCCCA
GGAGCAGCTATCTTTGTTC -> GAGCAGCTATCTTTGTTCT
TAAGGGGAGTGGTGTAGGA -> AAGGGGAGTGGTGTAGGAT
CGGGGGTCCGCTTCACAGA -> GGGGGTCCGCTTCACAGAA
CCTATTTCCCTCATGAGAC -> CTATTTCCCTCATGAGACG
CTTTGCGTCGTTTTCGTCG -> TTTGCGTCGTTTTCGTCGG
ATTTATAAGTCCGTTATCA -> TTTATAAGTCCGTTATCAT
TTATCAGCCGACCCAGGAG -> TATCAGCCGACCCAGGAGG
CTTGACGTCCGTCCGTAAA -> TTGACGTCCGTCCGTAAAT
CCATGATCTTGCCACGAAC -> CATGATCTTGCCACGAACC
GGACCAACAAGGACATGAT -> GACCAACAAGGACATGATC
TACGAGATCGGCACATGGC -> ACGAGATCGGCACATGGCC
AATACGTCGGGGGGTGCCG -> ATACGTCGGGGGGTGCCGG
TGGGAATTTAACGTGTGGA -> GGGAATTTAACGTGTGGAA
GGCGTCTATCTGTTGACCC -> GCGTCTATCTGTTGACCCG
CATCTCGCGTTTGAAGGTC -> ATCTCGCGTTTGAAGGTCT
GACGGCGTACCGATCTGCG -> ACGGCGTACCGATCTGCGC
TCAGTTCAGCGACATTAAA -> CAGTTCAGCGACATTAAAT
GTCGCATTCAAAGAGAGAA -> TCGCATTCAAAGAGAGAAA
GTTTGAAGGTCTCGTCTTA -> TTTGAAGGTCTCGTCTTAT
TAATACGATACAACAGTTA -> AATACGATACAACAGTTAT
GATCTGCGCCGTACCGTAA -> ATCTGCGCCGTACCGTAAC
AGTGCCCAAACCGTCAGGG -> GTGCCCAAACCGTCAGGGT
GCAGTCTCCATATTTCGGA -> CAGTCTCCATATTTCGGAC
TTGCACCCCCTCGTCTATT -> TGCACCCCCTCGTCTATTA
GGAATTGCAGATGTAGACA -> GAATTGCAGATGTAGACAT
GCCTCCTCCACAAAATGGT -> CCTCCTCCACAAAATGGTT
CCTCCGTCACTGAACATCT -> CTCCGTCACTGAACATCTC
TAGTTAAACGAATTTTGTT -> AGTTAAACGAATTTTGTTC
ATTAGGGCTGAAGATACAG -> TTAGGGCTGAAGATACAGA
TCAGTCGTTTCTTATTCCA -> CAGTCGTTTCTTATTCCAT
TTGAAGATGGAGTCGACCC -> TGAAGATGGAGTCGACCCA
GGCTGCCTACTGACTGTCC -> GCTGCCTACTGACTGTCCG
GCGACCTCGGGAGCAGCTA -> CGACCTCGGGAGCAGCTAT
CGTGCGATGACGGCTCCCG -> GTGCGATGACGGCTCCCGG
TGCACCCCCTCGTCTATTA -> GCACCCCCTCGTCTATTAG
ACAGAAAGGAGTGAGCTCG -> CAGAAAGGAGTGAGCTCGC
TTCTCAGATAAGGGGAGTG -> TCTCAGATAAGGGGAGTGG
CGCATTCAAAGAGAGAAAC -> GCATTCAAAGAGAGAAACG
GTATGCCGGAATTCAACTA -> TATGCCGGAATTCAACTAC
CGTTATCATGGAGCTGACG -> GTTATCATGGAGCTGACGG
TGCAGATGTAGACATTGGT -> GCAGATGTAGACATTGGTT
AATTGCAGATGTAGACATT -> ATTGCAGATGTAGACATTG
GCTCCTTCCTAGCAAATTT -> CTCCTTCCTAGCAAATTTT
AAAGGAGTGAGCTCGCGTT -> AAGGAGTGAGCTCGCGTTT
TTGTTCTTGCAGCTCAACG -> TGTTCTTGCAGCTCAACGA
ATAGCCTTTACTTCGAGAG -> TAGCCTTTACTTCGAGAGT
CATGAGACGAGCCTCGTTG -> ATGAGACGAGCCTCGTTGC
CAGCGACATTAAATAGACT -> AGCGACATTAAATAGACTA
GCTGTCGTCGGGGGTCCGC -> CTGTCGTCGGGGGTCCGCT
AGTGAGCTCGCGTTTGAAG -> GTGAGCTCGCGTTTGAAGG
GGTCTCATGCGGCGTCTGT -> GTCTCATGCGGCGTCTGTG
CCCTGTGGTCTGTTGCACC -> CCTGTGGTCTGTTGCACCC
CCGGGCTTACGACGCCCCT -> CGGGCTTACGACGCCCCTC
ACGAAACCGACTATCTAAT -> CGAAACCGACTATCTAATT
TGCTGAGATGCGCCAGAAT -> GCTGAGATGCGCCAGAATT
AAGAGTCCATTACGGGATG -> AGAGTCCATTACGGGATGT
TTGGAAAGAGAGGGAGTAG -> TGGAAAGAGAGGGAGTAGG
ACATCGATCGCCTGGCTCT -> CATCGATCGCCTGGCTCTT
ACCCAGGAGGGCCCCATGC -> CCCAGGAGGGCCCCATGCT
CTACTGACTGTCCGCCATG -> TACTGACTGTCCGCCATGA
GGGTGGTCAGTCAATGGGA -> GGTGGTCAGTCAATGGGAA
GGTCGCTGAGCGGGCTTGG -> GTCGCTGAGCGGGCTTGGC
ATTTTTGAAGATGGAGTCG -> TTTTTGAAGATGGAGTCGA
AGGAGGGATAGCTCTTACC -> GGAGGGATAGCTCTTACCC
CGGCACATGGCCGCCAGAC -> GGCACATGGCCGCCAGACA
TGAGGGTAGAACCAGCCGA -> GAGGGTAGAACCAGCCGAG
AATGGTTTTCGTATGCGGG -> ATGGTTTTCGTATGCGGGA
AGGGCTGAAGATACAGAAA -> GGGCTGAAGATACAGAAAG
GAAGATGGAGTCGACCCAT -> AAGATGGAGTCGACCCATC
GCCGTATGTCTACCTCCGT -> CCGTATGTCTACCTCCGTC
TTCCTATTTATGATCTTTA -> TCCTATTTATGATCTTTAA
TGCTACCGGAACATCGCAT -> GCTACCGGAACATCGCATT
TGTTCTCAGATAAGGGGAG -> GTTCTCAGATAAGGGGAGT
ATCAGGAGTACATGAAGCT -> TCAGGAGTACATGAAGCTC
CCCTTTGCATCGAATCAAA -> CCTTTGCATCGAATCAAAG
AACATTCGGATAGCGAGAG -> ACATTCGGATAGCGAGAGT
GAAATAGGGAGGAGATCCC -> AAATAGGGAGGAGATCCCT
TTAGAGGTCGTACAGACAT -> TAGAGGTCGTACAGACATG
GAGTAGATTCTTTAAATGG -> AGTAGATTCTTTAAATGGA
ATTCAAAGAGAGAAACGCT -> TTCAAAGAGAGAAACGCTT
GGGTCTCTAGTCACGAACC -> GGTCTCTAGTCACGAACCA
GACCTCGGGAGCAGCTATC -> ACCTCGGGAGCAGCTATCT
ACGGCTGGTGCTTACTCAT -> CGGCTGGTGCTTACTCATG
CGTATGCGGGATGTACTAA -> GTATGCGGGATGTACTAAG
TCTTGCAGCTCAACGAATG -> CTTGCAGCTCAACGAATGG
ATGGGAATTTAACGTGTGG -> TGGGAATTTAACGTGTGGA
CCTCCTCCACAAAATGGTT -> CTCCTCCACAAAATGGTTT
GGAAGCCGTATGTCTACCT -> GAAGCCGTATGTCTACCTC
GAATGGACACGTTGGAATT -> AATGGACACGTTGGAATTC
ACCGTGCGATGACGGCTCC -> CCGTGCGATGACGGCTCCC
TGTAGAATGGCTGGCCGTT -> GTAGAATGGCTGGCCGTTC
AGGGTGGTCAGTCAATGGG -> GGGTGGTCAGTCAATGGGA
TTGAAGGTCTCCCGTTGAA -> TGAAGGTCTCCCGTTGAAT
GGACGGCGGCGCCTTTGCG -> GACGGCGGCGCCTTTGCGT
CGTTCCTATTTCCCTCATG -> GTTCCTATTTCCCTCATGA
CACAGACTATTTTCTTGAC -> ACAGACTATTTTCTTGACG
GGTGATGAACATCCCCCTC -> GTGATGAACATCCCCCTCG
GGCATAAACGAAGGCCGGG -> GCATAAACGAAGGCCGGGT
CCGACCCAGGAGGGCCCCA -> CGACCCAGGAGGGCCCCAT
GGCAAATAGATGCGAAATA -> GCAAATAGATGCGAAATAC
CAGATGTAGACATTGGTTA -> AGATGTAGACATTGGTTAG
CAGTCAGTGCCCAAACCGT -> AGTCAGTGCCCAAACCGTC
ATGCTACGTTTAATAGCAC -> TGCTACGTTTAATAGCACG
GTCCTCCCCTTTGCATCGA -> TCCTCCCCTTTGCATCGAA
CTCGTTGCCCCCCCATCAT -> TCGTTGCCCCCCCATCATG
CCATTCAGATGAACATTCG -> CATTCAGATGAACATTCGG
GGACACCGGGCTTACGACG -> GACACCGGGCTTACGACGC
TGCGGCGTCTGTGGGGTGC -> GCGGCGTCTGTGGGGTGCA
GTTGCCCCCCCATCATGTA -> TTGCCCCCCCATCATGTAT
CGAAGGCCGGGTCTCTAGT -> GAAGGCCGGGTCTCTAGTC
GAGATCGGCACATGGCCGC -> AGATCGGCACATGGCCGCC
CTCCATATTTCGGACCAAC -> TCCATATTTCGGACCAACA
CAAAGTCGGCCTTTCTCTT -> AAAGTCGGCCTTTCTCTTG
CGCCATGATCTTGCCACGA -> GCCATGATCTTGCCACGAA
TCCTAGCAAATTTTGGCGT -> CCTAGCAAATTTTGGCGTC
TCGGACCAACAAGGACATG -> CGGACCAACAAGGACATGA
CCCATGAACCGTACCGGTT -> CCATGAACCGTACCGGTTT
GTCTCTAGTCACGAACCAA -> TCTCTAGTCACGAACCAAA
ACGCTTCTGAAGTCCTCCC -> CGCTTCTGAAGTCCTCCCC
ATCGGCACATGGCCGCCAG -> TCGGCACATGGCCGCCAGA
GGCCTTTTAAATACTAAGG -> GCCTTTTAAATACTAAGGT
CCAGACACTTGCGGTTTCA -> CAGACACTTGCGGTTTCAC
GTAGTGCATCCGATGTCGG -> TAGTGCATCCGATGTCGGG
GGTAAGAGTCCATTACGGG -> GTAAGAGTCCATTACGGGA
TACGACGCCCCTCGGGAAT -> ACGACGCCCCTCGGGAATT
GCTGGTCAACCCAGTCAGT -> CTGGTCAACCCAGTCAGTG
CCCCCTCGTCTATTAGAGG -> CCCCTCGTCTATTAGAGGT
ATTAACTATGGAAGCGTTA -> TTAACTATGGAAGCGTTAG
AGATCCCTCGCGTTTGAAG -> GATCCCTCGCGTTTGAAGG
ATTCGCTGGTCAACCCAGT -> TTCGCTGGTCAACCCAGTC
CGATCTGCGCCGTACCGTA -> GATCTGCGCCGTACCGTAA
ATAGATGCGAAATACGAGA -> TAGATGCGAAATACGAGAT
TGGGGTGCATTAGGGCTGC -> GGGGTGCATTAGGGCTGCA,GGGGTGCATTAGGGCTGCC,GGGGTGCATTAGGGCTGCC
AAGTGGTCAGTCTAAACAC -> AGTGGTCAGTCTAAACACT
TGGGGTGCATTAGGGCTGA -> GGGGTGCATTAGGGCTGAA
TATTGGTGCTGAGATGCGC -> ATTGGTGCTGAGATGCGCC
GATCGGCACATGGCCGCCA -> ATCGGCACATGGCCGCCAG
TCAACCCAGTCAGTGCCCA -> CAACCCAGTCAGTGCCCAA
TGTTCTTGCAGCTCAACGA -> GTTCTTGCAGCTCAACGAA
GTGCATTAGGGCTGCCTAA -> TGCATTAGGGCTGCCTAAT
GTGCATTAGGGCTGCCTAC -> TGCATTAGGGCTGCCTACT
AGGGATAGCTCTTACCCGT -> GGGATAGCTCTTACCCGTC
AGGTCTCATGCGGCGTCTG -> GGTCTCATGCGGCGTCTGT
ACATGGCCGCCAGACACTT -> CATGGCCGCCAGACACTTG
AATACAGGACACCGGGCTT -> ATACAGGACACCGGGCTTA
TGGTCTGTTGCACCCCCTC -> GGTCTGTTGCACCCCCTCG
TAGCCTTTACTTCGAGAGT -> AGCCTTTACTTCGAGAGTG
CCTTTGCGTCGTTTTCGTC -> CTTTGCGTCGTTTTCGTCG
TTATGATTGCTACCGGAAC -> TATGATTGCTACCGGAACA
TCGGGATTGACCGTGGGTC -> CGGGATTGACCGTGGGTCG
TATTAACGAAATACACAGA -> ATTAACGAAATACACAGAC
AGCTGACGGCTGGTGCTTA -> GCTGACGGCTGGTGCTTAC
GACCCATCCAGGGCATTCC -> ACCCATCCAGGGCATTCCC
GCATTAGGGCTGCATCCGT -> CATTAGGGCTGCATCCGTA
GGTGCTTACTCATGCTAGG -> GTGCTTACTCATGCTAGGG
ATTCCCTCGAGGCAATACA -> TTCCCTCGAGGCAATACAG
GGCGTCTGTGGGGTGCATT -> GCGTCTGTGGGGTGCATTA
CTAAGGGAGTCGTGTTCCC -> TAAGGGAGTCGTGTTCCCG
CTGACGGCTGGTGCTTACT -> TGACGGCTGGTGCTTACTC
CGAGGAGGGATAGCTCTTA -> GAGGAGGGATAGCTCTTAC
CACGAACCAAACAACACGG -> ACGAACCAAACAACACGGA
ATAGCGAGAGTGGGGTCGC -> TAGCGAGAGTGGGGTCGCT
GAAGGTCTCATGCGGCGTC -> AAGGTCTCATGCGGCGTCT
GTCTTATGTGAGTGGGGTG -> TCTTATGTGAGTGGGGTGC
AAAGAGAGAAACGCTTCTG -> AAGAGAGAAACGCTTCTGA
GAGGGTAGAACCAGCCGAG -> AGGGTAGAACCAGCCGAGA
GCCATGATCTTGCCACGAA -> CCATGATCTTGCCACGAAC
CGACCCATCCAGGGCATTC -> GACCCATCCAGGGCATTCC
GCGGTTTCACCGAGTGCCG -> CGGTTTCACCGAGTGCCGA
CTTGCAGCTCAACGAATGG -> TTGCAGCTCAACGAATGGA
ATCACAATACGTCGGGGGG -> TCACAATACGTCGGGGGGT
ATCTAATTCACTTGATATG -> TCTAATTCACTTGATATGT
GGCTACTATGCGCGGTCAC -> GCTACTATGCGCGGTCACG
TCAGATAAGGGGAGTGGTG -> CAGATAAGGGGAGTGGTGT
GAGGAGGGATAGCTCTTAC -> AGGAGGGATAGCTCTTACC
ATTCCTACAAGTGGTCAGT -> TTCCTACAAGTGGTCAGTC
ACACCGGGCTTACGACGCC -> CACCGGGCTTACGACGCCC
TAAAAAGTGTAACGAAACC -> AAAAAGTGTAACGAAACCG
ATCGATCGCCTGGCTCTTC -> TCGATCGCCTGGCTCTTCT
GGGAGTCGTGTTCCCGTTT -> GGAGTCGTGTTCCCGTTTA
GGGAACTCCCTGTGGTCTG -> GGAACTCCCTGTGGTCTGT
GAAGGTCTCTGCGGTGCCT -> AAGGTCTCTGCGGTGCCTT
GCGAGAGTGGGGTCGCTGA -> CGAGAGTGGGGTCGCTGAG
GGCTCCCGGCCTTTTAAAT -> GCTCCCGGCCTTTTAAATA
AACATCGCATTTATAAGTC -> ACATCGCATTTATAAGTCC
CCAGGAGGGCCCCATGCTA -> CAGGAGGGCCCCATGCTAC
CCAGCCGAGATGAGACAGG -> CAGCCGAGATGAGACAGGT
GGTCAGTCAATGGGAATTT -> GTCAGTCAATGGGAATTTA
CGTCTGTGGGGTGCATTAG -> GTCTGTGGGGTGCATTAGG
ACGAAGGCCGGGTCTCTAG -> CGAAGGCCGGGTCTCTAGT
TCCTCCACAAAATGGTTTT -> CCTCCACAAAATGGTTTTC
ATTGCTACCGGAACATCGC -> TTGCTACCGGAACATCGCA
GCATCGAATCAAAGTCGGC -> CATCGAATCAAAGTCGGCC
TGGAACTCGCGTTTGAAGG -> GGAACTCGCGTTTGAAGGT
CAGTCGTTTCTTATTCCAT -> AGTCGTTTCTTATTCCATT
TAATATTATCAGCCGACCC -> AATATTATCAGCCGACCCA
AACACTTGAGGGTAGAACC -> ACACTTGAGGGTAGAACCA
GGAGTGGTGTAGGATCCTT -> GAGTGGTGTAGGATCCTTT
ACAGACATGGACTCGTTAT -> CAGACATGGACTCGTTATT
CCTTTACTTCGAGAGTGTA -> CTTTACTTCGAGAGTGTAG
GCTTCACAGAATATCACAA -> CTTCACAGAATATCACAAT
CATCGCATTTATAAGTCCG -> ATCGCATTTATAAGTCCGT
AGGTGTTCCTATTTATGAT -> GGTGTTCCTATTTATGATC
TGAAGGTCTCTGCGGTGCC -> GAAGGTCTCTGCGGTGCCT
TAGGGCTGCATCCGTATTA -> AGGGCTGCATCCGTATTAA
TCCGTCACTGAACATCTCG -> CCGTCACTGAACATCTCGC
AAGGTCTCATGCGGCGTCT -> AGGTCTCATGCGGCGTCTG
GAGCCTCGTTGCCCCCCCA -> AGCCTCGTTGCCCCCCCAT
CACCGAGTGCCGAGGAGGG -> ACCGAGTGCCGAGGAGGGA
GACGAGCCTCGTTGCCCCC -> ACGAGCCTCGTTGCCCCCC
GCTCTTCTATGGCACCACA -> CTCTTCTATGGCACCACAG
AGGGCTGCATCCGTATTAA -> GGGCTGCATCCGTATTAAC
GGGGGGTGCCGGTGAAATA -> GGGGGTGCCGGTGAAATAG
TTACTCATGCTAGGGTAAG -> TACTCATGCTAGGGTAAGA
TGGTCAGTCAATGGGAATT -> GGTCAGTCAATGGGAATTT
CTGGAACTCGCGTTTGAAG -> TGGAACTCGCGTTTGAAGG
CGCCTGGCTCTTCTATGGC -> GCCTGGCTCTTCTATGGCA
CTGTGGGGTGCATTAGGGC -> TGTGGGGTGCATTAGGGCT
CCTGTCAGTTCAGCGACAT -> CTGTCAGTTCAGCGACATT
ATCGCATTTATAAGTCCGT -> TCGCATTTATAAGTCCGTT
GCTGGCCGTTCCTATTTCC -> CTGGCCGTTCCTATTTCCC
CAAAATGGTTTTCGTATGC -> AAAATGGTTTTCGTATGCG
CCCCCCATCATGTATGCCG -> CCCCCATCATGTATGCCGG
GCTACTATGCGCGGTCACG -> CTACTATGCGCGGTCACGT
GGGCATTCCCTGCTTGGCA -> GGCATTCCCTGCTTGGCAG
TCGTCTTATGTGAGTGGGG -> CGTCTTATGTGAGTGGGGT
CTGGTGCTTACTCATGCTA -> TGGTGCTTACTCATGCTAG
GCAAATTTTGGCGTCTATC -> CAAATTTTGGCGTCTATCT
GGTCTCGTCTTATGTGAGT -> GTCTCGTCTTATGTGAGTG
TTGGAATTCCCTCGAGGCA -> TGGAATTCCCTCGAGGCAA
TTCTGAAGTCCTCCCCTTT -> TCTGAAGTCCTCCCCTTTG
AAACCGTCAGGGTGGTCAG -> AACCGTCAGGGTGGTCAGT
TCTCATGCGGCGTCTGTGG -> CTCATGCGGCGTCTGTGGG
GTTCTCAGATAAGGGGAGT -> TTCTCAGATAAGGGGAGTG
AATGGCGACCTCGGGAGCA -> ATGGCGACCTCGGGAGCAG
GACATCGATCGCCTGGCTC -> ACATCGATCGCCTGGCTCT
AGGTCTCGTCTTATGTGAG -> GGTCTCGTCTTATGTGAGT
GCTACGTTTAATAGCACGC -> CTACGTTTAATAGCACGCT
TCGCTGGTCAACCCAGTCA -> CGCTGGTCAACCCAGTCAG
AGTCGTTTCTTATTCCATT -> GTCGTTTCTTATTCCATTC
TGCCTTGTGGGGTGCATTA -> GCCTTGTGGGGTGCATTAG
AATGCTGTGCTTATGATTG -> ATGCTGTGCTTATGATTGC
AATTCCTACAAGTGGTCAG -> ATTCCTACAAGTGGTCAGT
CTGCTTGGCAGTCTCCATA -> TGCTTGGCAGTCTCCATAT
TGTACTAAGGGAGTCGTGT -> GTACTAAGGGAGTCGTGTT
CGGGATGTCCTTTACCAGG -> GGGATGTCCTTTACCAGGG
CGAGCTTATTCGGGATTGA -> GAGCTTATTCGGGATTGAC
CTACTATGCGCGGTCACGT -> TACTATGCGCGGTCACGTT
TGCCTGTCAGATTTCAGAT -> GCCTGTCAGATTTCAGATG
AGATTCTTTAAATGGACGG -> GATTCTTTAAATGGACGGC
GCAAATAGATGCGAAATAC -> CAAATAGATGCGAAATACG
GAGTGTAGCTGAGTAGATT -> AGTGTAGCTGAGTAGATTC
CTAGTCACGAACCAAACAA -> TAGTCACGAACCAAACAAC
CGGCGTACCGATCTGCGCC -> GGCGTACCGATCTGCGCCG
GCATTCAAAGAGAGAAACG -> CATTCAAAGAGAGAAACGC
CGCCAGAATTCCTACAAGT -> GCCAGAATTCCTACAAGTG
TGCTTCGGCATAAACGAAG -> GCTTCGGCATAAACGAAGG
CTCTTCCTAGACATGGCAC -> TCTTCCTAGACATGGCACG
CTGGCCGTTCCTATTTCCC -> TGGCCGTTCCTATTTCCCT
CCTCGAGGCAATACAGGAC -> CTCGAGGCAATACAGGACA
TCGCATTCAAAGAGAGAAA -> CGCATTCAAAGAGAGAAAC
TCAGATGGTGATGAACATC -> CAGATGGTGATGAACATCC
GATAATATTATCAGCCGAC -> ATAATATTATCAGCCGACC
CTCCTGTCAGTTCAGCGAC -> TCCTGTCAGTTCAGCGACA
ATTCGGATAGCGAGAGTGG -> TTCGGATAGCGAGAGTGGG
GATGTACTAAGGGAGTCGT -> ATGTACTAAGGGAGTCGTG
TCTCTTGTAACCCATGAAC -> CTCTTGTAACCCATGAACC
GTGGTCAGTCAATGGGAAT -> TGGTCAGTCAATGGGAATT
CAACAGTTATAGCCTTTAC -> AACAGTTATAGCCTTTACT
GAACATTCGGATAGCGAGA -> AACATTCGGATAGCGAGAG
TGGAGCTGACGGCTGGTGC -> GGAGCTGACGGCTGGTGCT
CCCGTCCTATGTAGAATGG -> CCGTCCTATGTAGAATGGC
ATCGCCTGGCTCTTCTATG -> TCGCCTGGCTCTTCTATGG
CTGAGTAGATTCTTTAAAT -> TGAGTAGATTCTTTAAATG
GCTTGGCTTAGCACTATAA -> CTTGGCTTAGCACTATAAT
CATTAACTATGGAAGCGTT -> ATTAACTATGGAAGCGTTA
CTCGGGAGCAGCTATCTTT -> TCGGGAGCAGCTATCTTTG
ACCTGCCTGTCAGATTTCA -> CCTGCCTGTCAGATTTCAG
ACCGTGGGTCGCATTCAAA -> CCGTGGGTCGCATTCAAAG
TAATTCACTTGATATGTTA -> AATTCACTTGATATGTTAT
CGGGATTGACCGTGGGTCG -> GGGATTGACCGTGGGTCGC
AACTCCTGTCAGTTCAGCG -> ACTCCTGTCAGTTCAGCGA
TTACTTCGAGAGTGTAGCT -> TACTTCGAGAGTGTAGCTG
GAAGTCCTCCCCTTTGCAT -> AAGTCCTCCCCTTTGCATC
AATTAGATAATATTATCAG -> ATTAGATAATATTATCAGC
TCTCTGCGGTGCCTTGTGG -> CTCTGCGGTGCCTTGTGGG
TCGTACAGACATGGACTCG -> CGTACAGACATGGACTCGT
TTGAGGGTAGAACCAGCCG -> TGAGGGTAGAACCAGCCGA
AGAATATCACAATACGTCG -> GAATATCACAATACGTCGG
TCACGTTAGGTGTTCCTAT -> CACGTTAGGTGTTCCTATT
CAGACATGGACTCGTTATT -> AGACATGGACTCGTTATTC
TCTAGTCACGAACCAAACA -> CTAGTCACGAACCAAACAA
ATACACAGACTATTTTCTT -> TACACAGACTATTTTCTTG
CATTCGGATAGCGAGAGTG -> ATTCGGATAGCGAGAGTGG
GGAACTCGCGTTTGAAGGT -> GAACTCGCGTTTGAAGGTC
GGTGCCGGTGAAATAGGGA -> GTGCCGGTGAAATAGGGAG
TAGCGAGAGTGGGGTCGCT -> AGCGAGAGTGGGGTCGCTG
TAGGCGTAGTGCATCCGAT -> AGGCGTAGTGCATCCGATG
TAACGAAATACACAGACTA -> AACGAAATACACAGACTAT
CGTCTATTAGAGGTCGTAC -> GTCTATTAGAGGTCGTACA
GGGTGCATTAGGGCTGCAT -> GGTGCATTAGGGCTGCATC
AGATACAGAAAGGAGTGAG -> GATACAGAAAGGAGTGAGC
TGTTGCACCCCCTCGTCTA -> GTTGCACCCCCTCGTCTAT
AACGAAACCGACTATCTAA -> ACGAAACCGACTATCTAAT
TCGGCCTTTCTCTTGTAAC -> CGGCCTTTCTCTTGTAACC
ATCAGGTGGGCCTCCTCCA -> TCAGGTGGGCCTCCTCCAC
ATAGACTATGATAGGCGTA -> TAGACTATGATAGGCGTAG
TTTGAAGGTCTCGTCTTAT -> TTGAAGGTCTCGTCTTATG
GCGGTGCCTTGTGGGGTGC -> CGGTGCCTTGTGGGGTGCA
TGGTGGTAAAAAGTGTAAC -> GGTGGTAAAAAGTGTAACG
TTAACGAAATACACAGACT -> TAACGAAATACACAGACTA
AGCAAATTTTGGCGTCTAT -> GCAAATTTTGGCGTCTATC
TAGGGCTGAAGATACAGAA -> AGGGCTGAAGATACAGAAA
CATGGACTCGTTATTCAGT -> ATGGACTCGTTATTCAGTC
TTGCCCCCCCATCATGTAT -> TGCCCCCCCATCATGTATG
TCATGCGGCGTCTGTGGGG -> CATGCGGCGTCTGTGGGGT
AGGAGATCCCTCGCGTTTG -> GGAGATCCCTCGCGTTTGA
CTAGCAAATTTTGGCGTCT -> TAGCAAATTTTGGCGTCTA
CTATGCGCGGTCACGTTAG -> TATGCGCGGTCACGTTAGG
AGGGCCCCATGCTACGTTT -> GGGCCCCATGCTACGTTTA
ATTAGAGGTCGTACAGACA -> TTAGAGGTCGTACAGACAT
GAACTCGCGTTTGAAGGTC -> AACTCGCGTTTGAAGGTCT
TGACGTCCGTCCGTAAATG -> GACGTCCGTCCGTAAATGG
TATTTCGGACCAACAAGGA -> ATTTCGGACCAACAAGGAC
GTTGGAATTCCCTCGAGGC -> TTGGAATTCCCTCGAGGCA
GATTGCTACCGGAACATCG -> ATTGCTACCGGAACATCGC
CGGCGTCTGTGGGGTGCAT -> GGCGTCTGTGGGGTGCATT
CCGTAACTCCTGTCAGTTC -> CGTAACTCCTGTCAGTTCA
TCCCCCTCGTCTGGAACTC -> CCCCCTCGTCTGGAACTCG
TCGCGTTTGAAGGTCTCAT -> CGCGTTTGAAGGTCTCATG
CCTGGCTCTTCTATGGCAC -> CTGGCTCTTCTATGGCACC
TTCCGGCACGAGTTAGAAT -> TCCGGCACGAGTTAGAATC
ATATTATCAGCCGACCCAG -> TATTATCAGCCGACCCAGG
GGTGGGCCTCCTCCACAAA -> GTGGGCCTCCTCCACAAAA
GCGCCAGAATTCCTACAAG -> CGCCAGAATTCCTACAAGT
GGGGTGCATTAGGGCTGAA -> GGGTGCATTAGGGCTGAAG
AGCTCGCGTTTGAAGGTCT -> GCTCGCGTTTGAAGGTCTC
GCATTAGGGCTGCCTAATT -> CATTAGGGCTGCCTAATTC
CAATAAACGCAAGGGCAAA -> AATAAACGCAAGGGCAAAT
TGTGAGTGGGGTGCATTAG -> GTGAGTGGGGTGCATTAGG
CTGAGATGCGCCAGAATTC -> TGAGATGCGCCAGAATTCC
GGCTCTTCTATGGCACCAC -> GCTCTTCTATGGCACCACA
TGGCCGTTCCTATTTCCCT -> GGCCGTTCCTATTTCCCTC
GACTATTTTCTTGACGTCC -> ACTATTTTCTTGACGTCCG
CACAGGCCCTGTGGTGGTA -> ACAGGCCCTGTGGTGGTAA
TATGTAGAATGGCTGGCCG -> ATGTAGAATGGCTGGCCGT
CATGCGGCGTCTGTGGGGT -> ATGCGGCGTCTGTGGGGTG
GACGTCCGTCCGTAAATGG -> ACGTCCGTCCGTAAATGGC
CATCCGTATTAACGAAATA -> ATCCGTATTAACGAAATAC
TCCTTTACCAGGGTTTTCG -> CCTTTACCAGGGTTTTCGT
TATTCCATTCAGATGAACA -> ATTCCATTCAGATGAACAT
GAAATACGAGATCGGCACA -> AAATACGAGATCGGCACAT
CTTTAATACGATACAACAG -> TTTAATACGATACAACAGT
CGAGTTAGAATCAGGTGGG -> GAGTTAGAATCAGGTGGGC
AATTCAACTACCGTGCGAT -> ATTCAACTACCGTGCGATG
TCTGCGGTGCCTTGTGGGG -> CTGCGGTGCCTTGTGGGGT
TTCTCTTGTAACCCATGAA -> TCTCTTGTAACCCATGAAC
CGGCTCCCGGCCTTTTAAA -> GGCTCCCGGCCTTTTAAAT
TTCCCGTTTATGCGACATC -> TCCCGTTTATGCGACATCG
TTGCTACCGGAACATCGCA -> TGCTACCGGAACATCGCAT
GGAACTCCCTGTGGTCTGT -> GAACTCCCTGTGGTCTGTT
ACCTATTGGCCCCCAATAA -> CCTATTGGCCCCCAATAAA
TTCGTTCCCAACAAGCTAA -> TCGTTCCCAACAAGCTAAA
TGGAATTCCCTCGAGGCAA -> GGAATTCCCTCGAGGCAAT
TGCTTACTCATGCTAGGGT -> GCTTACTCATGCTAGGGTA
CTCGCGTTTGAAGGTCTCG -> TCGCGTTTGAAGGTCTCGT
TTCCCTCATGAGACGAGCC -> TCCCTCATGAGACGAGCCT
TAGGGCTGCCTACTGACTG -> AGGGCTGCCTACTGACTGT
GTTTGAAGGTCTCATGCGG -> TTTGAAGGTCTCATGCGGC
ATTAGATAATATTATCAGC -> TTAGATAATATTATCAGCC
CGTTGAATAAGTGGGGTGC -> GTTGAATAAGTGGGGTGCA
CTAGACATGGCACGGTCTA -> TAGACATGGCACGGTCTAG
GACGGCTGGTGCTTACTCA -> ACGGCTGGTGCTTACTCAT
TTCTATGGCACCACAGGCC -> TCTATGGCACCACAGGCCC
CTTTACCAGGGTTTTCGTT -> TTTACCAGGGTTTTCGTTC
CCAAACAACACGGAAATTA -> CAAACAACACGGAAATTAG
GCTGAGCGGGCTTGGCTTA -> CTGAGCGGGCTTGGCTTAG
CAGAATATCACAATACGTC -> AGAATATCACAATACGTCG
CCGGTGAAATAGGGAGGAG -> CGGTGAAATAGGGAGGAGA
TGACTGTCCGCCATGATCT -> GACTGTCCGCCATGATCTT
CCGTACCGTAACTCCTGTC -> CGTACCGTAACTCCTGTCA
CACCCCCTCGTCTATTAGA -> ACCCCCTCGTCTATTAGAG
TTGGCAGTCTCCATATTTC -> TGGCAGTCTCCATATTTCG
TCGTTTTCGTCGGGCTACT -> CGTTTTCGTCGGGCTACTA
CAGAATTCCTACAAGTGGT -> AGAATTCCTACAAGTGGTC
TATTTATGATCTTTAATAC -> ATTTATGATCTTTAATACG
GTTTTCGTTCCCAACAAGC -> TTTTCGTTCCCAACAAGCT
GTGGGCCTCCTCCACAAAA -> TGGGCCTCCTCCACAAAAT
GGCTTAGCACTATAATGCT -> GCTTAGCACTATAATGCTG
GCATAAACGAAGGCCGGGT -> CATAAACGAAGGCCGGGTC
CGTTTGAAGGTCTCCCGTT -> GTTTGAAGGTCTCCCGTTG
AGGGGAGTGGTGTAGGATC -> GGGGAGTGGTGTAGGATCC
AGATGAACATTCGGATAGC -> GATGAACATTCGGATAGCG
TAGGATCCTTTTCCGGCAC -> AGGATCCTTTTCCGGCACG
TCAGTCAATGGGAATTTAA -> CAGTCAATGGGAATTTAAC
GAGAGTGGGGTCGCTGAGC -> AGAGTGGGGTCGCTGAGCG
GTGCCTTGTGGGGTGCATT -> TGCCTTGTGGGGTGCATTA
TCTTATGTGAGTGGGGTGC -> CTTATGTGAGTGGGGTGCA
ACATGATCAGGAGTACATG -> CATGATCAGGAGTACATGA
GCTTACTCATGCTAGGGTA -> CTTACTCATGCTAGGGTAA
TAGTCACGAACCAAACAAC -> AGTCACGAACCAAACAACA
GACTATCTAATTCACTTGA -> ACTATCTAATTCACTTGAT
GATCCCTCGCGTTTGAAGG -> ATCCCTCGCGTTTGAAGGT
GGTGAAATAGGGAGGAGAT -> GTGAAATAGGGAGGAGATC
TGACCGTGGGTCGCATTCA -> GACCGTGGGTCGCATTCAA
TGAAGCTCTTCCTAGACAT -> GAAGCTCTTCCTAGACATG
CAATACAGGACACCGGGCT -> AATACAGGACACCGGGCTT
GAATATCACAATACGTCGG -> AATATCACAATACGTCGGG
AAAGTGTAACGAAACCGAC -> AAGTGTAACGAAACCGACT
CCCCCCCATCATGTATGCC -> CCCCCCATCATGTATGCCG
CGGGTCTCTAGTCACGAAC -> GGGTCTCTAGTCACGAACC
CGTCGGGGGGTGCCGGTGA -> GTCGGGGGGTGCCGGTGAA
CGATACAACAGTTATAGCC -> GATACAACAGTTATAGCCT
GCGGCGTCTGTGGGGTGCA -> CGGCGTCTGTGGGGTGCAT
CACCACAGGCCCTGTGGTG -> ACCACAGGCCCTGTGGTGG
GGGCTGCCTACTGACTGTC -> GGCTGCCTACTGACTGTCC
GGGCTACTATGCGCGGTCA -> GGCTACTATGCGCGGTCAC
AGTCCATTACGGGATGTCC -> GTCCATTACGGGATGTCCT
CTAGGGTAAGAGTCCATTA -> TAGGGTAAGAGTCCATTAC
CTCCACAAAATGGTTTTCG -> TCCACAAAATGGTTTTCGT
TAAACTGCTTCGGCATAAA -> AAACTGCTTCGGCATAAAC
GAGCAGCTATCTTTGTTCT -> AGCAGCTATCTTTGTTCTC
TGCGTCGTTTTCGTCGGGC -> GCGTCGTTTTCGTCGGGCT
TCAGGGTGGTCAGTCAATG -> CAGGGTGGTCAGTCAATGG
CTGCGCCGTACCGTAACTC -> TGCGCCGTACCGTAACTCC
TAGCTGAGTAGATTCTTTA -> AGCTGAGTAGATTCTTTAA
GCCTTGTGGGGTGCATTAG -> CCTTGTGGGGTGCATTAGG
CCTCGTCTGGAACTCGCGT -> CTCGTCTGGAACTCGCGTT
TCTCGTCTTATGTGAGTGG -> CTCGTCTTATGTGAGTGGG
GAACATCGCATTTATAAGT -> AACATCGCATTTATAAGTC
GGCTGCATCCGTATTAACG -> GCTGCATCCGTATTAACGA
GTCACGTTAGGTGTTCCTA -> TCACGTTAGGTGTTCCTAT
CACAAAATGGTTTTCGTAT -> ACAAAATGGTTTTCGTATG
ATTCAGTCGTTTCTTATTC -> TTCAGTCGTTTCTTATTCC
GCATTAGGGCTGCCTACTG -> CATTAGGGCTGCCTACTGA
GGATAGCGAGAGTGGGGTC -> GATAGCGAGAGTGGGGTCG
AAACTGCTTCGGCATAAAC -> AACTGCTTCGGCATAAACG
ATTCTTTAAATGGACGGCG -> TTCTTTAAATGGACGGCGT
TTTACCAGGGTTTTCGTTC -> TTACCAGGGTTTTCGTTCC
TTGAAGGTCTCTGCGGTGC -> TGAAGGTCTCTGCGGTGCC
GGTCAACCCAGTCAGTGCC -> GTCAACCCAGTCAGTGCCC
GTTCAGCGACATTAAATAG -> TTCAGCGACATTAAATAGA
AGCTGAGTAGATTCTTTAA -> GCTGAGTAGATTCTTTAAA
CCGTATTAACGAAATACAC -> CGTATTAACGAAATACACA
AATTTAACGTGTGGAAGCC -> ATTTAACGTGTGGAAGCCG
CGCGTTTGAAGGTCTCCCG -> GCGTTTGAAGGTCTCCCGT
AGCCGTATGTCTACCTCCG -> GCCGTATGTCTACCTCCGT
TTCGGCATAAACGAAGGCC -> TCGGCATAAACGAAGGCCG
GACTATGATAGGCGTAGTG -> ACTATGATAGGCGTAGTGC
GGGAATTTAACGTGTGGAA -> GGAATTTAACGTGTGGAAG
CGTATTTTTGAAGATGGAG -> GTATTTTTGAAGATGGAGT
TACTAAGGGAGTCGTGTTC -> ACTAAGGGAGTCGTGTTCC
GCACTATAATGCTGTGCTT -> CACTATAATGCTGTGCTTA
TCCATATTTCGGACCAACA -> CCATATTTCGGACCAACAA
CGTTTGAAGGTCTCTGCGG -> GTTTGAAGGTCTCTGCGGT
GGAGGAGATCCCTCGCGTT -> GAGGAGATCCCTCGCGTTT
TTAATAGCACGCTGTCGTC -> TAATAGCACGCTGTCGTCG
TGTGGTGGTAAAAAGTGTA -> GTGGTGGTAAAAAGTGTAA
GTTTTCGTCGGGCTACTAT -> TTTTCGTCGGGCTACTATG
GGCCTTTCTCTTGTAACCC -> GCCTTTCTCTTGTAACCCA
CGCATTTATAAGTCCGTTA -> GCATTTATAAGTCCGTTAT
AGGCGTAGTGCATCCGATG -> GGCGTAGTGCATCCGATGT
TGCTAGGGTAAGAGTCCAT -> GCTAGGGTAAGAGTCCATT
TCCTAGACATGGCACGGTC -> CCTAGACATGGCACGGTCT
GCGGTCACGTTAGGTGTTC -> CGGTCACGTTAGGTGTTCC
TGCTTGGCAGTCTCCATAT -> GCTTGGCAGTCTCCATATT
GCCCAAACCGTCAGGGTGG -> CCCAAACCGTCAGGGTGGT
TGTCGGGAACTCCCTGTGG -> GTCGGGAACTCCCTGTGGT
CTACCCGTTCAGCAGTCTC -> TACCCGTTCAGCAGTCTCC
GGGATTGACCGTGGGTCGC -> GGATTGACCGTGGGTCGCA
ATATCACAATACGTCGGGG -> TATCACAATACGTCGGGGG
GCGATGACGGCTCCCGGCC -> CGATGACGGCTCCCGGCCT
GCTGTGCTTATGATTGCTA -> CTGTGCTTATGATTGCTAC
GAACCAGCCGAGATGAGAC -> AACCAGCCGAGATGAGACA
GCCGTACCGTAACTCCTGT -> CCGTACCGTAACTCCTGTC
CATGCTACGTTTAATAGCA -> ATGCTACGTTTAATAGCAC
GTTCTTGCAGCTCAACGAA -> TTCTTGCAGCTCAACGAAT
CGGTGAAATAGGGAGGAGA -> GGTGAAATAGGGAGGAGAT
TGGTGCTTACTCATGCTAG -> GGTGCTTACTCATGCTAGG
AGAATCAGGTGGGCCTCCT -> GAATCAGGTGGGCCTCCTC
TAGACTATGATAGGCGTAG -> AGACTATGATAGGCGTAGT
AATAAACGCAAGGGCAAAT -> ATAAACGCAAGGGCAAATA
TCCCTGCTTGGCAGTCTCC -> CCCTGCTTGGCAGTCTCCA
CATCCCCCTCGTCTGGAAC -> ATCCCCCTCGTCTGGAACT
GACGGCTCCCGGCCTTTTA -> ACGGCTCCCGGCCTTTTAA
CATTCCCTGCTTGGCAGTC -> ATTCCCTGCTTGGCAGTCT
GTTTGAAGGTCTCTGCGGT -> TTTGAAGGTCTCTGCGGTG
ATAAACGAAGGCCGGGTCT -> TAAACGAAGGCCGGGTCTC
CCGGTTTAAGCTCCTTCCT -> CGGTTTAAGCTCCTTCCTA
CACGAACCTGCCTGTCAGA -> ACGAACCTGCCTGTCAGAT
GTGGTAAAAAGTGTAACGA -> TGGTAAAAAGTGTAACGAA
ATGAACCGTACCGGTTTAA -> TGAACCGTACCGGTTTAAG
GTCCGCTTCACAGAATATC -> TCCGCTTCACAGAATATCA
ATTTCCCTCATGAGACGAG -> TTTCCCTCATGAGACGAGC
GAGTACATGAAGCTCTTCC -> AGTACATGAAGCTCTTCCT
ATTAGGGCTGCATCCGTAT -> TTAGGGCTGCATCCGTATT
CTCATGCGGCGTCTGTGGG -> TCATGCGGCGTCTGTGGGG
GCTAGGGTAAGAGTCCATT -> CTAGGGTAAGAGTCCATTA
AAGCCGTATGTCTACCTCC -> AGCCGTATGTCTACCTCCG
CCCCATCATGTATGCCGGA -> CCCATCATGTATGCCGGAA
TACGTCGGGGGGTGCCGGT -> ACGTCGGGGGGTGCCGGTG
GCATCCGTATTAACGAAAT -> CATCCGTATTAACGAAATA
AGGGAGGAGATCCCTCGCG -> GGGAGGAGATCCCTCGCGT
GTCCTATGTAGAATGGCTG -> TCCTATGTAGAATGGCTGG
ATTACGGGATGTCCTTTAC -> TTACGGGATGTCCTTTACC
TGGAAAGAGAGGGAGTAGG -> GGAAAGAGAGGGAGTAGGG
ACTCGTTATTCAGTCGTTT -> CTCGTTATTCAGTCGTTTC
ACTACCGAGCTTATTCGGG -> CTACCGAGCTTATTCGGGA
GTTAGAATCAGGTGGGCCT -> TTAGAATCAGGTGGGCCTC
TCGTTGCCCCCCCATCATG -> CGTTGCCCCCCCATCATGT
CTTGGCTTAGCACTATAAT -> TTGGCTTAGCACTATAATG
CACGAGTTAGAATCAGGTG -> ACGAGTTAGAATCAGGTGG
AACGAAATACACAGACTAT -> ACGAAATACACAGACTATT
AGCTCTTCCTAGACATGGC -> GCTCTTCCTAGACATGGCA
AAGCTAAACTGCTTCGGCA -> AGCTAAACTGCTTCGGCAT
GCACATGGCCGCCAGACAC -> CACATGGCCGCCAGACACT
TTCAGATGGTGATGAACAT -> TCAGATGGTGATGAACATC
ACTTCGAGAGTGTAGCTGA -> CTTCGAGAGTGTAGCTGAG
GTGGGTCGCATTCAAAGAG -> TGGGTCGCATTCAAAGAGA
AGACTATGATAGGCGTAGT -> GACTATGATAGGCGTAGTG
CCGACTATCTAATTCACTT -> CGACTATCTAATTCACTTG
ATGGCACCACAGGCCCTGT -> TGGCACCACAGGCCCTGTG
CCGTATTTTTGAAGATGGA -> CGTATTTTTGAAGATGGAG
AGTCCTCCCCTTTGCATCG -> GTCCTCCCCTTTGCATCGA
GGAATTTAACGTGTGGAAG -> GAATTTAACGTGTGGAAGC
TGGGTCGCATTCAAAGAGA -> GGGTCGCATTCAAAGAGAG
TGAACATTCGGATAGCGAG -> GAACATTCGGATAGCGAGA
ATCTGTTGACCCGTGGACG -> TCTGTTGACCCGTGGACGG
CGAATGGACACGTTGGAAT -> GAATGGACACGTTGGAATT
CACGCTGTCGTCGGGGGTC -> ACGCTGTCGTCGGGGGTCC
ATTTTGTTCTTGCAGCTCA -> TTTTGTTCTTGCAGCTCAA
CGAATCAAAGTCGGCCTTT -> GAATCAAAGTCGGCCTTTC
CCTTTGCATCGAATCAAAG -> CTTTGCATCGAATCAAAGT
GAGTCCATTACGGGATGTC -> AGTCCATTACGGGATGTCC
CGACCTCGGGAGCAGCTAT -> GACCTCGGGAGCAGCTATC
AAGTCCGTTATCATGGAGC -> AGTCCGTTATCATGGAGCT
TACAACAGTTATAGCCTTT -> ACAACAGTTATAGCCTTTA
GGGAATTGCAGATGTAGAC -> GGAATTGCAGATGTAGACA
GGGCTGAAGATACAGAAAG -> GGCTGAAGATACAGAAAGG
CTTATTCCATTCAGATGAA -> TTATTCCATTCAGATGAAC
TTACGACGCCCCTCGGGAA -> TACGACGCCCCTCGGGAAT
ACACGGAAATTAGATAATA -> CACGGAAATTAGATAATAT
TCGAGAGTGTAGCTGAGTA -> CGAGAGTGTAGCTGAGTAG
CTCGTCTGGAACTCGCGTT -> TCGTCTGGAACTCGCGTTT
TAACTATGGAAGCGTTAGG -> AACTATGGAAGCGTTAGGA
TTGCGGTTTCACCGAGTGC -> TGCGGTTTCACCGAGTGCC
TTATCATGGAGCTGACGGC -> TATCATGGAGCTGACGGCT
CTACCTCCGTCACTGAACA -> TACCTCCGTCACTGAACAT
CCCGTTTATGCGACATCGA -> CCGTTTATGCGACATCGAT
AAGATGGAGTCGACCCATC -> AGATGGAGTCGACCCATCC
AGGTCGTACAGACATGGAC -> GGTCGTACAGACATGGACT
AGTCTAAACACTTGAGGGT -> GTCTAAACACTTGAGGGTA
ACCCATCCAGGGCATTCCC -> CCCATCCAGGGCATTCCCT
CCCCTCGTCTGGAACTCGC -> CCCTCGTCTGGAACTCGCG
TACCGAGCTTATTCGGGAT -> ACCGAGCTTATTCGGGATT
TTAGGGCTGCCTAATTCGC -> TAGGGCTGCCTAATTCGCT
TGGCCGCCAGACACTTGCG -> GGCCGCCAGACACTTGCGG
GTACCGGTTTAAGCTCCTT -> TACCGGTTTAAGCTCCTTC
GTCCGTTATCATGGAGCTG -> TCCGTTATCATGGAGCTGA
AATTTTGGCGTCTATCTGT -> ATTTTGGCGTCTATCTGTT
AATACGATACAACAGTTAT -> ATACGATACAACAGTTATA
AATACGAGATCGGCACATG -> ATACGAGATCGGCACATGG
CGAAATACACAGACTATTT -> GAAATACACAGACTATTTT
ACGACGCCCCTCGGGAATT -> CGACGCCCCTCGGGAATTG
CTTTCTCTTGTAACCCATG -> TTTCTCTTGTAACCCATGA
CAGGGCATTCCCTGCTTGG -> AGGGCATTCCCTGCTTGGC
AGGTCTCCCGTTGAATAAG -> GGTCTCCCGTTGAATAAGT
CCCTCGTCTATTAGAGGTC -> CCTCGTCTATTAGAGGTCG
TCTATTAGAGGTCGTACAG -> CTATTAGAGGTCGTACAGA
ACGTTTAATAGCACGCTGT -> CGTTTAATAGCACGCTGTC
GCGTCGTTTTCGTCGGGCT -> CGTCGTTTTCGTCGGGCTA
GGTCTGTTGCACCCCCTCG -> GTCTGTTGCACCCCCTCGT
ACAGGTTAATTACTGGCCG -> CAGGTTAATTACTGGCCGT
GTTATAGCCTTTACTTCGA -> TTATAGCCTTTACTTCGAG
TTGCAGCTCAACGAATGGA -> TGCAGCTCAACGAATGGAC
GGCTTGGCTTAGCACTATA -> GCTTGGCTTAGCACTATAA
TCGCCTGGCTCTTCTATGG -> CGCCTGGCTCTTCTATGGC
CCCTCGAGGCAATACAGGA -> CCTCGAGGCAATACAGGAC
CAGTTCAGCGACATTAAAT -> AGTTCAGCGACATTAAATA
ACAAGGACATGATCAGGAG -> CAAGGACATGATCAGGAGT
TTCGGACCAACAAGGACAT -> TCGGACCAACAAGGACATG
CGGGCTACTATGCGCGGTC -> GGGCTACTATGCGCGGTCA
GTAGAATGGCTGGCCGTTC -> TAGAATGGCTGGCCGTTCC
TTGGCGTCTATCTGTTGAC -> TGGCGTCTATCTGTTGACC
TAAGTGGGGTGCATTAGGG -> AAGTGGGGTGCATTAGGGC
CGTTAGGACTACCGAGCTT -> GTTAGGACTACCGAGCTTA
GCTCTTACCCGTCCTATGT -> CTCTTACCCGTCCTATGTA
CAAAGAGAGAAACGCTTCT -> AAAGAGAGAAACGCTTCTG
CTCAGATAAGGGGAGTGGT -> TCAGATAAGGGGAGTGGTG
CCACAGGCCCTGTGGTGGT -> CACAGGCCCTGTGGTGGTA
AGATGCGAAATACGAGATC -> GATGCGAAATACGAGATCG
ACTACCGTGCGATGACGGC -> CTACCGTGCGATGACGGCT
AGATTTCAGATGGTGATGA -> GATTTCAGATGGTGATGAA
CGTATGTCTACCTCCGTCA -> GTATGTCTACCTCCGTCAC
GTACCGATCTGCGCCGTAC -> TACCGATCTGCGCCGTACC
TTATTGGAAAGAGAGGGAG -> TATTGGAAAGAGAGGGAGT
CGTAAATGGCGACCTCGGG -> GTAAATGGCGACCTCGGGA
CGTTAGGTGTTCCTATTTA -> GTTAGGTGTTCCTATTTAT
CATCATGTATGCCGGAATT -> ATCATGTATGCCGGAATTC
TGCCCCCCCATCATGTATG -> GCCCCCCCATCATGTATGC
TGCATTAGGGCTGCCTAAT -> GCATTAGGGCTGCCTAATT
TACGTTTAATAGCACGCTG -> ACGTTTAATAGCACGCTGT
CTGGCTCTTCTATGGCACC -> TGGCTCTTCTATGGCACCA
GTCACGAACCAAACAACAC -> TCACGAACCAAACAACACG
GGGTGCATTAGGGCTGAAG -> GGTGCATTAGGGCTGAAGA
GCCCCATGCTACGTTTAAT -> CCCCATGCTACGTTTAATA
TGACGGCTGGTGCTTACTC -> GACGGCTGGTGCTTACTCA
CGTACCGGTTTAAGCTCCT -> GTACCGGTTTAAGCTCCTT
ATGGAGTCGACCCATCCAG -> TGGAGTCGACCCATCCAGG
ACGAATGGACACGTTGGAA -> CGAATGGACACGTTGGAAT
CGCTGAGCGGGCTTGGCTT -> GCTGAGCGGGCTTGGCTTA
TGTCCGCCATGATCTTGCC -> GTCCGCCATGATCTTGCCA
TTCCTAGACATGGCACGGT -> TCCTAGACATGGCACGGTC
ATACGATACAACAGTTATA -> TACGATACAACAGTTATAG
GATATGTTATTGGAAAGAG -> ATATGTTATTGGAAAGAGA
CTTTAAATGGACGGCGTAC -> TTTAAATGGACGGCGTACC
ATCAGCCGACCCAGGAGGG -> TCAGCCGACCCAGGAGGGC
GGCCGTTCCGTATTTTTGA -> GCCGTTCCGTATTTTTGAA
CAGCCGACCCAGGAGGGCC -> AGCCGACCCAGGAGGGCCC
GAACTCCCTGTGGTCTGTT -> AACTCCCTGTGGTCTGTTG
GGACTACCGAGCTTATTCG -> GACTACCGAGCTTATTCGG
TAGATGCGAAATACGAGAT -> AGATGCGAAATACGAGATC
GTTCCCAACAAGCTAAACT -> TTCCCAACAAGCTAAACTG
GAGAGGGAGTAGGGACCTA -> AGAGGGAGTAGGGACCTAT
GCGACATTAAATAGACTAT -> CGACATTAAATAGACTATG
CCCTCGCGTTTGAAGGTCT -> CCTCGCGTTTGAAGGTCTC
ATTGACCGTGGGTCGCATT -> TTGACCGTGGGTCGCATTC
ATAGGGAGGAGATCCCTCG -> TAGGGAGGAGATCCCTCGC
CGAGATCGGCACATGGCCG -> GAGATCGGCACATGGCCGC
TTAGGGCCTACCCGTTCAG -> TAGGGCCTACCCGTTCAGC
TTTTCGTCGGGCTACTATG -> TTTCGTCGGGCTACTATGC
CGAAACCGACTATCTAATT -> GAAACCGACTATCTAATTC
ATCGAATCAAAGTCGGCCT -> TCGAATCAAAGTCGGCCTT
ACTCCTGTCAGTTCAGCGA -> CTCCTGTCAGTTCAGCGAC
ACAGTTATAGCCTTTACTT -> CAGTTATAGCCTTTACTTC
TCGTGTTCCCGTTTATGCG -> CGTGTTCCCGTTTATGCGA
CGAGATGAGACAGGTTAAT -> GAGATGAGACAGGTTAATT
GTCCTTTACCAGGGTTTTC -> TCCTTTACCAGGGTTTTCG
TCGCGTTTGAAGGTCTCCC -> CGCGTTTGAAGGTCTCCCG
CCGTACCGGTTTAAGCTCC -> CGTACCGGTTTAAGCTCCT
AGGAGTGAGCTCGCGTTTG -> GGAGTGAGCTCGCGTTTGA
GGGGGTGCCGGTGAAATAG -> GGGGTGCCGGTGAAATAGG
CGGGAGCAGCTATCTTTGT -> GGGAGCAGCTATCTTTGTT
AGCCGAGATGAGACAGGTT -> GCCGAGATGAGACAGGTTA
GATGAACATCCCCCTCGTC -> ATGAACATCCCCCTCGTCT
ATGGCTGGCCGTTCCTATT -> TGGCTGGCCGTTCCTATTT
CTATGGAAGCGTTAGGACT -> TATGGAAGCGTTAGGACTA
GGGGTGCATTAGGGCTGCA -> GGGTGCATTAGGGCTGCAT
GTCGGGAACTCCCTGTGGT -> TCGGGAACTCCCTGTGGTC
GGGGTGCATTAGGGCTGCC -> GGGTGCATTAGGGCTGCCT,GGGTGCATTAGGGCTGCCT
CTATGATAGGCGTAGTGCA -> TATGATAGGCGTAGTGCAT
GTTAGGACTACCGAGCTTA -> TTAGGACTACCGAGCTTAT
ACCAAACAACACGGAAATT -> CCAAACAACACGGAAATTA
TACCGATCTGCGCCGTACC -> ACCGATCTGCGCCGTACCG
GAGGGCCCCATGCTACGTT -> AGGGCCCCATGCTACGTTT
CTAATTCGCTGGTCAACCC -> TAATTCGCTGGTCAACCCA
CGGAACATCGCATTTATAA -> GGAACATCGCATTTATAAG
TATCACAATACGTCGGGGG -> ATCACAATACGTCGGGGGG
GGTCACGTTAGGTGTTCCT -> GTCACGTTAGGTGTTCCTA
CCATCCAGGGCATTCCCTG -> CATCCAGGGCATTCCCTGC
AGGTTAATTACTGGCCGTT -> GGTTAATTACTGGCCGTTC
CCCAACAAGCTAAACTGCT -> CCAACAAGCTAAACTGCTT
GCCACGAACCTGCCTGTCA -> CCACGAACCTGCCTGTCAG
TACAGGACACCGGGCTTAC -> ACAGGACACCGGGCTTACG
TACCGGAACATCGCATTTA -> ACCGGAACATCGCATTTAT
GAAATACACAGACTATTTT -> AAATACACAGACTATTTTC
GTGCATTAGGGCTGAAGAT -> TGCATTAGGGCTGAAGATA
AGAAAGGAGTGAGCTCGCG -> GAAAGGAGTGAGCTCGCGT
AAAAGTGTAACGAAACCGA -> AAAGTGTAACGAAACCGAC
AGTAGGGACCTATTGGCCC -> GTAGGGACCTATTGGCCCC
AGTTATAGCCTTTACTTCG -> GTTATAGCCTTTACTTCGA
AGATGAGACAGGTTAATTA -> GATGAGACAGGTTAATTAC
GCTGAAGATACAGAAAGGA -> CTGAAGATACAGAAAGGAG
AGAGAGAAACGCTTCTGAA -> GAGAGAAACGCTTCTGAAG
AACCGTCAGGGTGGTCAGT -> ACCGTCAGGGTGGTCAGTC
CATGAACCGTACCGGTTTA -> ATGAACCGTACCGGTTTAA
CCGGCACGAGTTAGAATCA -> CGGCACGAGTTAGAATCAG
GCAGCTCAACGAATGGACA -> CAGCTCAACGAATGGACAC
GCGTAGTGCATCCGATGTC -> CGTAGTGCATCCGATGTCG
GATCTTTAATACGATACAA -> ATCTTTAATACGATACAAC
CGTCTTATGTGAGTGGGGT -> GTCTTATGTGAGTGGGGTG
GAGAAACGCTTCTGAAGTC -> AGAAACGCTTCTGAAGTCC
CATGATCTTGCCACGAACC -> ATGATCTTGCCACGAACCT
TATTAGAGGTCGTACAGAC -> ATTAGAGGTCGTACAGACA
GTCCGTAAATGGCGACCTC -> TCCGTAAATGGCGACCTCG
TTTCGTCGGGCTACTATGC -> TTCGTCGGGCTACTATGCG
GAGCGGGCTTGGCTTAGCA -> AGCGGGCTTGGCTTAGCAC
TGTGGGGTGCATTAGGGCT -> GTGGGGTGCATTAGGGCTG,GTGGGGTGCATTAGGGCTG
GAAAGAGAGGGAGTAGGGA -> AAAGAGAGGGAGTAGGGAC
GCTTCTGAAGTCCTCCCCT -> CTTCTGAAGTCCTCCCCTT
GCCGTTCCGTATTTTTGAA -> CCGTTCCGTATTTTTGAAG
CGTCGTTTTCGTCGGGCTA -> GTCGTTTTCGTCGGGCTAC
CTGTGGTCTGTTGCACCCC -> TGTGGTCTGTTGCACCCCC
GGAGCTGACGGCTGGTGCT -> GAGCTGACGGCTGGTGCTT
GGGTGCATTAGGGCTGCCT -> GGTGCATTAGGGCTGCCTA,GGTGCATTAGGGCTGCCTA
ATTAGGGCTGCCTAATTCG -> TTAGGGCTGCCTAATTCGC
CACATGGCCGCCAGACACT -> ACATGGCCGCCAGACACTT
CATATTTCGGACCAACAAG -> ATATTTCGGACCAACAAGG
GTGTAGGATCCTTTTCCGG -> TGTAGGATCCTTTTCCGGC
GTCGCTGAGCGGGCTTGGC -> TCGCTGAGCGGGCTTGGCT
ATGGCCGCCAGACACTTGC -> TGGCCGCCAGACACTTGCG
GCTCCCGGCCTTTTAAATA -> CTCCCGGCCTTTTAAATAC
GGACATGATCAGGAGTACA -> GACATGATCAGGAGTACAT
TTGGCTTAGCACTATAATG -> TGGCTTAGCACTATAATGC
GAATGGCTGGCCGTTCCTA -> AATGGCTGGCCGTTCCTAT
GGAGTCGACCCATCCAGGG -> GAGTCGACCCATCCAGGGC
TTTTGGCGTCTATCTGTTG -> TTTGGCGTCTATCTGTTGA
AAATTAGATAATATTATCA -> AATTAGATAATATTATCAG
ATCCGATGTCGGGAACTCC -> TCCGATGTCGGGAACTCCC
GATGTCGGGAACTCCCTGT -> ATGTCGGGAACTCCCTGTG
ACGGGATGTCCTTTACCAG -> CGGGATGTCCTTTACCAGG
TGTCAGATTTCAGATGGTG -> GTCAGATTTCAGATGGTGA
GTAAAAAGTGTAACGAAAC -> TAAAAAGTGTAACGAAACC
GTGCATTAGGGCTGCATCC -> TGCATTAGGGCTGCATCCG
GAAATTAGATAATATTATC -> AAATTAGATAATATTATCA
AGGGTTTTCGTTCCCAACA -> GGGTTTTCGTTCCCAACAA
GTCCGCCATGATCTTGCCA -> TCCGCCATGATCTTGCCAC
GGGCTTGGCTTAGCACTAT -> GGCTTGGCTTAGCACTATA
CGGCGCCTTTGCGTCGTTT -> GGCGCCTTTGCGTCGTTTT
CTTGTGGGGTGCATTAGGG -> TTGTGGGGTGCATTAGGGC
CCACAAAATGGTTTTCGTA -> CACAAAATGGTTTTCGTAT
TGTATGCCGGAATTCAACT -> GTATGCCGGAATTCAACTA
TAGGGTAAGAGTCCATTAC -> AGGGTAAGAGTCCATTACG
TACAGAAAGGAGTGAGCTC -> ACAGAAAGGAGTGAGCTCG
GAACCGTACCGGTTTAAGC -> AACCGTACCGGTTTAAGCT
CCTTTACCAGGGTTTTCGT -> CTTTACCAGGGTTTTCGTT
TATTTTCTTGACGTCCGTC -> ATTTTCTTGACGTCCGTCC
GTATGTCTACCTCCGTCAC -> TATGTCTACCTCCGTCACT
TGTGGAAGCCGTATGTCTA -> GTGGAAGCCGTATGTCTAC
GACTCGTTATTCAGTCGTT -> ACTCGTTATTCAGTCGTTT
TCTTGCCACGAACCTGCCT -> CTTGCCACGAACCTGCCTG
TGCGCCGTACCGTAACTCC -> GCGCCGTACCGTAACTCCT
TCCTATTTATGATCTTTAA -> CCTATTTATGATCTTTAAT
TGCTGTGCTTATGATTGCT -> GCTGTGCTTATGATTGCTA
TTTCCCTCATGAGACGAGC -> TTCCCTCATGAGACGAGCC
ATTGCAGATGTAGACATTG -> TTGCAGATGTAGACATTGG
CGATCGCCTGGCTCTTCTA -> GATCGCCTGGCTCTTCTAT
GACACTTGCGGTTTCACCG -> ACACTTGCGGTTTCACCGA
AGTTAAACGAATTTTGTTC -> GTTAAACGAATTTTGTTCT
CAACAAGCTAAACTGCTTC -> AACAAGCTAAACTGCTTCG
ATGAGACGAGCCTCGTTGC -> TGAGACGAGCCTCGTTGCC
TACACAGACTATTTTCTTG -> ACACAGACTATTTTCTTGA
AACGCAAGGGCAAATAGAT -> ACGCAAGGGCAAATAGATG
CAGATTTCAGATGGTGATG -> AGATTTCAGATGGTGATGA
TGAGACAGGTTAATTACTG -> GAGACAGGTTAATTACTGG
TGGTTTTCGTATGCGGGAT -> GGTTTTCGTATGCGGGATG
TGAAGATACAGAAAGGAGT -> GAAGATACAGAAAGGAGTG
CGTACCGTAACTCCTGTCA -> GTACCGTAACTCCTGTCAG
CCAGTCAGTGCCCAAACCG -> CAGTCAGTGCCCAAACCGT
TCCTTCCTAGCAAATTTTG -> CCTTCCTAGCAAATTTTGG
TTCGTATGCGGGATGTACT -> TCGTATGCGGGATGTACTA
CTGTCGTCGGGGGTCCGCT -> TGTCGTCGGGGGTCCGCTT
TCAGCGACATTAAATAGAC -> CAGCGACATTAAATAGACT
ATGAGACAGGTTAATTACT -> TGAGACAGGTTAATTACTG
ACCCAGTCAGTGCCCAAAC -> CCCAGTCAGTGCCCAAACC
TTCCCTGCTTGGCAGTCTC -> TCCCTGCTTGGCAGTCTCC
TAAATGGCGACCTCGGGAG -> AAATGGCGACCTCGGGAGC
CGAGAGTGTAGCTGAGTAG -> GAGAGTGTAGCTGAGTAGA
TCGATCGCCTGGCTCTTCT -> CGATCGCCTGGCTCTTCTA
AGATGTAGACATTGGTTAG -> GATGTAGACATTGGTTAGG
ACATCTCGCGTTTGAAGGT -> CATCTCGCGTTTGAAGGTC
AACAAGCTAAACTGCTTCG -> ACAAGCTAAACTGCTTCGG
TATTCGGGATTGACCGTGG -> ATTCGGGATTGACCGTGGG
CTACCGGAACATCGCATTT -> TACCGGAACATCGCATTTA
TTAAATAGACTATGATAGG -> TAAATAGACTATGATAGGC
GGCCCCCAATAAACGCAAG -> GCCCCCAATAAACGCAAGG
TAAGCTCCTTCCTAGCAAA -> AAGCTCCTTCCTAGCAAAT
GTTATCATGGAGCTGACGG -> TTATCATGGAGCTGACGGC
GGCCCCATGCTACGTTTAA -> GCCCCATGCTACGTTTAAT
TTTCGTTCCCAACAAGCTA -> TTCGTTCCCAACAAGCTAA
GCGTTTGAAGGTCTCATGC -> CGTTTGAAGGTCTCATGCG
TGCCGGTGAAATAGGGAGG -> GCCGGTGAAATAGGGAGGA
GTCTATTAGAGGTCGTACA -> TCTATTAGAGGTCGTACAG
AAATAGGGAGGAGATCCCT -> AATAGGGAGGAGATCCCTC
GGAGTACATGAAGCTCTTC -> GAGTACATGAAGCTCTTCC
AACAACACGGAAATTAGAT -> ACAACACGGAAATTAGATA
GGGAGTGGTGTAGGATCCT -> GGAGTGGTGTAGGATCCTT
GCGAAATACGAGATCGGCA -> CGAAATACGAGATCGGCAC
AGTAGATTCTTTAAATGGA -> GTAGATTCTTTAAATGGAC
TACCGTAACTCCTGTCAGT -> ACCGTAACTCCTGTCAGTT
ATGCGAAATACGAGATCGG -> TGCGAAATACGAGATCGGC
CGGTCACGTTAGGTGTTCC -> GGTCACGTTAGGTGTTCCT
GACAGGTTAATTACTGGCC -> ACAGGTTAATTACTGGCCG
GATGCGAAATACGAGATCG -> ATGCGAAATACGAGATCGG
GTGCTTACTCATGCTAGGG -> TGCTTACTCATGCTAGGGT
CTTTGTTCTCAGATAAGGG -> TTTGTTCTCAGATAAGGGG
GTGCATCCGATGTCGGGAA -> TGCATCCGATGTCGGGAAC
CTACCGAGCTTATTCGGGA -> TACCGAGCTTATTCGGGAT
GGGCTGCATCCGTATTAAC -> GGCTGCATCCGTATTAACG
TATGTCTACCTCCGTCACT -> ATGTCTACCTCCGTCACTG
TGTCAGTTCAGCGACATTA -> GTCAGTTCAGCGACATTAA
TTCCCTCGAGGCAATACAG -> TCCCTCGAGGCAATACAGG
CATTTATAAGTCCGTTATC -> ATTTATAAGTCCGTTATCA
CCGAGGAGGGATAGCTCTT -> CGAGGAGGGATAGCTCTTA
GAAGGTCTCCCGTTGAATA -> AAGGTCTCCCGTTGAATAA
GGTTAGGGCCTACCCGTTC -> GTTAGGGCCTACCCGTTCA
TCCGCTTCACAGAATATCA -> CCGCTTCACAGAATATCAC
AACAGTTATAGCCTTTACT -> ACAGTTATAGCCTTTACTT
GGTCTAGTTAAACGAATTT -> GTCTAGTTAAACGAATTTT
CCCGGCCTTTTAAATACTA -> CCGGCCTTTTAAATACTAA
TATGCGACATCGATCGCCT -> ATGCGACATCGATCGCCTG
GTAGACATTGGTTAGGGCC -> TAGACATTGGTTAGGGCCT
AAAATGGTTTTCGTATGCG -> AAATGGTTTTCGTATGCGG
CGGTTTCACCGAGTGCCGA -> GGTTTCACCGAGTGCCGAG
TCGTATGCGGGATGTACTA -> CGTATGCGGGATGTACTAA
TCCGTAAATGGCGACCTCG -> CCGTAAATGGCGACCTCGG
GAAGGCCGGGTCTCTAGTC -> AAGGCCGGGTCTCTAGTCA
CTATTAGAGGTCGTACAGA -> TATTAGAGGTCGTACAGAC
CGTTTAATAGCACGCTGTC -> GTTTAATAGCACGCTGTCG
AGTCGTGTTCCCGTTTATG -> GTCGTGTTCCCGTTTATGC
TGGGGTCGCTGAGCGGGCT -> GGGGTCGCTGAGCGGGCTT
GTTCAGCAGTCTCCAAAGC -> TTCAGCAGTCTCCAAAGCC
GGTGTAGGATCCTTTTCCG -> GTGTAGGATCCTTTTCCGG
TTATAGCCTTTACTTCGAG -> TATAGCCTTTACTTCGAGA
TAGCACTATAATGCTGTGC -> AGCACTATAATGCTGTGCT
CTTATTCGGGATTGACCGT -> TTATTCGGGATTGACCGTG
ACAGGCCCTGTGGTGGTAA -> CAGGCCCTGTGGTGGTAAA
GCACCACAGGCCCTGTGGT -> CACCACAGGCCCTGTGGTG
GGCGCCTTTGCGTCGTTTT -> GCGCCTTTGCGTCGTTTTC
TGCTACGTTTAATAGCACG -> GCTACGTTTAATAGCACGC
AAACGCAAGGGCAAATAGA -> AACGCAAGGGCAAATAGAT
GAACATCTCGCGTTTGAAG -> AACATCTCGCGTTTGAAGG
CCGTTGAATAAGTGGGGTG -> CGTTGAATAAGTGGGGTGC
AGGGCATTCCCTGCTTGGC -> GGGCATTCCCTGCTTGGCA
TTCGTCGGGCTACTATGCG -> TCGTCGGGCTACTATGCGC
TCACGAACCAAACAACACG -> CACGAACCAAACAACACGG
TCGGGAACTCCCTGTGGTC -> CGGGAACTCCCTGTGGTCT
ACCGTCAGGGTGGTCAGTC -> CCGTCAGGGTGGTCAGTCA
ACAGACTATTTTCTTGACG -> CAGACTATTTTCTTGACGT
GCATTCCCTGCTTGGCAGT -> CATTCCCTGCTTGGCAGTC
CCTAGCAAATTTTGGCGTC -> CTAGCAAATTTTGGCGTCT
CGACGCCCCTCGGGAATTG -> GACGCCCCTCGGGAATTGC
TCAGTCTAAACACTTGAGG -> CAGTCTAAACACTTGAGGG
TCATGGAGCTGACGGCTGG -> CATGGAGCTGACGGCTGGT
TTAAGCTCCTTCCTAGCAA -> TAAGCTCCTTCCTAGCAAA
CTGCCTAATTCGCTGGTCA -> TGCCTAATTCGCTGGTCAA
CTCATGAGACGAGCCTCGT -> TCATGAGACGAGCCTCGTT
ACGTCGGGGGGTGCCGGTG -> CGTCGGGGGGTGCCGGTGA
AGGGCTGCCTACTGACTGT -> GGGCTGCCTACTGACTGTC
CGATGTCGGGAACTCCCTG -> GATGTCGGGAACTCCCTGT
TGGACTCGTTATTCAGTCG -> GGACTCGTTATTCAGTCGT
TTACGGGATGTCCTTTACC -> TACGGGATGTCCTTTACCA
TTCACTTGATATGTTATTG -> TCACTTGATATGTTATTGG
GCTGAGTAGATTCTTTAAA -> CTGAGTAGATTCTTTAAAT
TCTTTAAATGGACGGCGTA -> CTTTAAATGGACGGCGTAC
ACGAACCTGCCTGTCAGAT -> CGAACCTGCCTGTCAGATT
TGTAGGATCCTTTTCCGGC -> GTAGGATCCTTTTCCGGCA
GTATTGGTGCTGAGATGCG -> TATTGGTGCTGAGATGCGC
ATTTTCTTGACGTCCGTCC -> TTTTCTTGACGTCCGTCCG
CACGGTCTAGTTAAACGAA -> ACGGTCTAGTTAAACGAAT
CTATGTAGAATGGCTGGCC -> TATGTAGAATGGCTGGCCG
GACCAACAAGGACATGATC -> ACCAACAAGGACATGATCA
GAAGCGTTAGGACTACCGA -> AAGCGTTAGGACTACCGAG
TGTTCCTATTTATGATCTT -> GTTCCTATTTATGATCTTT
CTCGCGTTTGAAGGTCTCA -> TCGCGTTTGAAGGTCTCAT
AACGAAGGCCGGGTCTCTA -> ACGAAGGCCGGGTCTCTAG
CTCGCGTTTGAAGGTCTCC -> TCGCGTTTGAAGGTCTCCC
TGAGACGAGCCTCGTTGCC -> GAGACGAGCCTCGTTGCCC
TATAGCCTTTACTTCGAGA -> ATAGCCTTTACTTCGAGAG
TACATGAAGCTCTTCCTAG -> ACATGAAGCTCTTCCTAGA
TTGCCACGAACCTGCCTGT -> TGCCACGAACCTGCCTGTC
TGAGTGGGGTGCATTAGGG -> GAGTGGGGTGCATTAGGGC
TTACCCGTCCTATGTAGAA -> TACCCGTCCTATGTAGAAT
GGTCTCTGCGGTGCCTTGT -> GTCTCTGCGGTGCCTTGTG
CAGAAAGGAGTGAGCTCGC -> AGAAAGGAGTGAGCTCGCG
CTCGCGTTTGAAGGTCTCT -> TCGCGTTTGAAGGTCTCTG
GTGAAATAGGGAGGAGATC -> TGAAATAGGGAGGAGATCC
TCGCGTTTGAAGGTCTCTG -> CGCGTTTGAAGGTCTCTGC
GTGTTCCTATTTATGATCT -> TGTTCCTATTTATGATCTT
GCGCCTTTGCGTCGTTTTC -> CGCCTTTGCGTCGTTTTCG
GGGTCGCATTCAAAGAGAG -> GGTCGCATTCAAAGAGAGA
AGTCGGCCTTTCTCTTGTA -> GTCGGCCTTTCTCTTGTAA
CTTTACTTCGAGAGTGTAG -> TTTACTTCGAGAGTGTAGC
GCATTAGGGCTGAAGATAC -> CATTAGGGCTGAAGATACA
GCCGAGGAGGGATAGCTCT -> CCGAGGAGGGATAGCTCTT
TTTCTTGACGTCCGTCCGT -> TTCTTGACGTCCGTCCGTA
CGACCCAGGAGGGCCCCAT -> GACCCAGGAGGGCCCCATG
GAAACCGACTATCTAATTC -> AAACCGACTATCTAATTCA
AATTACTGGCCGTTCCGTA -> ATTACTGGCCGTTCCGTAT
TATTATCAGCCGACCCAGG -> ATTATCAGCCGACCCAGGA
GGGGTCGCTGAGCGGGCTT -> GGGTCGCTGAGCGGGCTTG
GAGCTCGCGTTTGAAGGTC -> AGCTCGCGTTTGAAGGTCT
CGAGAGTGGGGTCGCTGAG -> GAGAGTGGGGTCGCTGAGC
AAATACTAAGGTATTGGTG -> AATACTAAGGTATTGGTGC
CTAGTTAAACGAATTTTGT -> TAGTTAAACGAATTTTGTT
CTTAGCACTATAATGCTGT -> TTAGCACTATAATGCTGTG
CGTCCTATGTAGAATGGCT -> GTCCTATGTAGAATGGCTG
TTCAGCGACATTAAATAGA -> TCAGCGACATTAAATAGAC
ATCCGTATTAACGAAATAC -> TCCGTATTAACGAAATACA
GAATTTAACGTGTGGAAGC -> AATTTAACGTGTGGAAGCC
ACGGTCTAGTTAAACGAAT -> CGGTCTAGTTAAACGAATT
GTAGATTCTTTAAATGGAC -> TAGATTCTTTAAATGGACG
CACGGAAATTAGATAATAT -> ACGGAAATTAGATAATATT
AGTCTCCATATTTCGGACC -> GTCTCCATATTTCGGACCA
TAGGGAGGAGATCCCTCGC -> AGGGAGGAGATCCCTCGCG
TCCGTATTTTTGAAGATGG -> CCGTATTTTTGAAGATGGA
GGTGGTAAAAAGTGTAACG -> GTGGTAAAAAGTGTAACGA
TGCTTATGATTGCTACCGG -> GCTTATGATTGCTACCGGA
ACGCTGTCGTCGGGGGTCC -> CGCTGTCGTCGGGGGTCCG
CGCTTCTGAAGTCCTCCCC -> GCTTCTGAAGTCCTCCCCT
GATAGCTCTTACCCGTCCT -> ATAGCTCTTACCCGTCCTA
TGCATCCGATGTCGGGAAC -> GCATCCGATGTCGGGAACT
TATGCCGGAATTCAACTAC -> ATGCCGGAATTCAACTACC
GGTGTTCCTATTTATGATC -> GTGTTCCTATTTATGATCT
GGCCGGGTCTCTAGTCACG -> GCCGGGTCTCTAGTCACGA
GACTACCGAGCTTATTCGG -> ACTACCGAGCTTATTCGGG
CAGGCCCTGTGGTGGTAAA -> AGGCCCTGTGGTGGTAAAA
AATAGACTATGATAGGCGT -> ATAGACTATGATAGGCGTA
TAGAGGTCGTACAGACATG -> AGAGGTCGTACAGACATGG
AGCTCAACGAATGGACACG -> GCTCAACGAATGGACACGT
GTAGAACCAGCCGAGATGA -> TAGAACCAGCCGAGATGAG
CGGGAACTCCCTGTGGTCT -> GGGAACTCCCTGTGGTCTG
TGCATTAGGGCTGCCTACT -> GCATTAGGGCTGCCTACTG
CACGTTGGAATTCCCTCGA -> ACGTTGGAATTCCCTCGAG
TTTGCATCGAATCAAAGTC -> TTGCATCGAATCAAAGTCG
GTTTGAAGGTCTCCCGTTG -> TTTGAAGGTCTCCCGTTGA
CTTTTAAATACTAAGGTAT -> TTTTAAATACTAAGGTATT
TAGAACCAGCCGAGATGAG -> AGAACCAGCCGAGATGAGA
GTTTTCGTATGCGGGATGT -> TTTTCGTATGCGGGATGTA
ACCGATCTGCGCCGTACCG -> CCGATCTGCGCCGTACCGT
ACGAGTTAGAATCAGGTGG -> CGAGTTAGAATCAGGTGGG
GTGCCGGTGAAATAGGGAG -> TGCCGGTGAAATAGGGAGG
GGACGGCGTACCGATCTGC -> GACGGCGTACCGATCTGCG
CTTGGCAGTCTCCATATTT -> TTGGCAGTCTCCATATTTC
AAACAACACGGAAATTAGA -> AACAACACGGAAATTAGAT
CTCCCTGTGGTCTGTTGCA -> TCCCTGTGGTCTGTTGCAC
TCTCAGATAAGGGGAGTGG -> CTCAGATAAGGGGAGTGGT
CATTGGTTAGGGCCTACCC -> ATTGGTTAGGGCCTACCCG
CCGGCCTTTTAAATACTAA -> CGGCCTTTTAAATACTAAG
AGCACGCTGTCGTCGGGGG -> GCACGCTGTCGTCGGGGGT
AGACATGGACTCGTTATTC -> GACATGGACTCGTTATTCA
CTGTCAGATTTCAGATGGT -> TGTCAGATTTCAGATGGTG
AATGGGAATTTAACGTGTG -> ATGGGAATTTAACGTGTGG
GTTATTCAGTCGTTTCTTA -> TTATTCAGTCGTTTCTTAT
CAGACTATTTTCTTGACGT -> AGACTATTTTCTTGACGTC
TGAAATAGGGAGGAGATCC -> GAAATAGGGAGGAGATCCC
CAACTACCGTGCGATGACG -> AACTACCGTGCGATGACGG
AGCGTTAGGACTACCGAGC -> GCGTTAGGACTACCGAGCT
TGTTGACCCGTGGACGGCG -> GTTGACCCGTGGACGGCGG
TTTGTTCTCAGATAAGGGG -> TTGTTCTCAGATAAGGGGA
AACCAGCCGAGATGAGACA -> ACCAGCCGAGATGAGACAG
GCCAGAATTCCTACAAGTG -> CCAGAATTCCTACAAGTGG
TAAGGGAGTCGTGTTCCCG -> AAGGGAGTCGTGTTCCCGT
CGTAACTCCTGTCAGTTCA -> GTAACTCCTGTCAGTTCAG
TCGACCCATCCAGGGCATT -> CGACCCATCCAGGGCATTC
AGGGCAAATAGATGCGAAA -> GGGCAAATAGATGCGAAAT
GAAAGGAGTGAGCTCGCGT -> AAAGGAGTGAGCTCGCGTT
AGGCCCTGTGGTGGTAAAA -> GGCCCTGTGGTGGTAAAAA
GAATTTTGTTCTTGCAGCT -> AATTTTGTTCTTGCAGCTC
CTGTGGTGGTAAAAAGTGT -> TGTGGTGGTAAAAAGTGTA
GGCCTCCTCCACAAAATGG -> GCCTCCTCCACAAAATGGT
ACGAGCCTCGTTGCCCCCC -> CGAGCCTCGTTGCCCCCCC
CTTACCCGTCCTATGTAGA -> TTACCCGTCCTATGTAGAA
GGGGTGCCGGTGAAATAGG -> GGGTGCCGGTGAAATAGGG
TATGGAAGCGTTAGGACTA -> ATGGAAGCGTTAGGACTAC
GTCCGTCCGTAAATGGCGA -> TCCGTCCGTAAATGGCGAC
ATCATGTATGCCGGAATTC -> TCATGTATGCCGGAATTCA
GGATGTACTAAGGGAGTCG -> GATGTACTAAGGGAGTCGT
GAGTGAGCTCGCGTTTGAA -> AGTGAGCTCGCGTTTGAAG
ACCGGTTTAAGCTCCTTCC -> CCGGTTTAAGCTCCTTCCT
AGACGAGCCTCGTTGCCCC -> GACGAGCCTCGTTGCCCCC
CATTACGGGATGTCCTTTA -> ATTACGGGATGTCCTTTAC
AACAAGGACATGATCAGGA -> ACAAGGACATGATCAGGAG
TCATGTATGCCGGAATTCA -> CATGTATGCCGGAATTCAA
CAGTCAATGGGAATTTAAC -> AGTCAATGGGAATTTAACG
CCCATGCTACGTTTAATAG -> CCATGCTACGTTTAATAGC
AAATGGACGGCGTACCGAT -> AATGGACGGCGTACCGATC
CAGTTATAGCCTTTACTTC -> AGTTATAGCCTTTACTTCG
ATTGGTTAGGGCCTACCCG -> TTGGTTAGGGCCTACCCGT
GTCTGTGGGGTGCATTAGG -> TCTGTGGGGTGCATTAGGG
GGTGGTCAGTCAATGGGAA -> GTGGTCAGTCAATGGGAAT
AGCCTCGTTGCCCCCCCAT -> GCCTCGTTGCCCCCCCATC
TGTGCTTATGATTGCTACC -> GTGCTTATGATTGCTACCG
GAATTCCCTCGAGGCAATA -> AATTCCCTCGAGGCAATAC
AGTGGGGTCGCTGAGCGGG -> GTGGGGTCGCTGAGCGGGC
AAATGGTTTTCGTATGCGG -> AATGGTTTTCGTATGCGGG
ATAAGTCCGTTATCATGGA -> TAAGTCCGTTATCATGGAG
CCGTGGACGGCGGCGCCTT -> CGTGGACGGCGGCGCCTTT
GTCTAGTTAAACGAATTTT -> TCTAGTTAAACGAATTTTG
ATAAGGGGAGTGGTGTAGG -> TAAGGGGAGTGGTGTAGGA
GTGGTGGTAAAAAGTGTAA -> TGGTGGTAAAAAGTGTAAC
AAGTGTAACGAAACCGACT -> AGTGTAACGAAACCGACTA
TTGCAGATGTAGACATTGG -> TGCAGATGTAGACATTGGT
TCATGAGACGAGCCTCGTT -> CATGAGACGAGCCTCGTTG
AACCGTACCGGTTTAAGCT -> ACCGTACCGGTTTAAGCTC
CACCGGGCTTACGACGCCC -> ACCGGGCTTACGACGCCCC
CCTAATTCGCTGGTCAACC -> CTAATTCGCTGGTCAACCC
TCAGGTGGGCCTCCTCCAC -> CAGGTGGGCCTCCTCCACA
CTTCCTAGACATGGCACGG -> TTCCTAGACATGGCACGGT
ATTCACTTGATATGTTATT -> TTCACTTGATATGTTATTG
TGCCACGAACCTGCCTGTC -> GCCACGAACCTGCCTGTCA
AGAATGGCTGGCCGTTCCT -> GAATGGCTGGCCGTTCCTA
TGATCTTGCCACGAACCTG -> GATCTTGCCACGAACCTGC
CGTCGGGCTACTATGCGCG -> GTCGGGCTACTATGCGCGG
GGGGGTCCGCTTCACAGAA -> GGGGTCCGCTTCACAGAAT
CGGATAGCGAGAGTGGGGT -> GGATAGCGAGAGTGGGGTC
GCACGAGTTAGAATCAGGT -> CACGAGTTAGAATCAGGTG
AGTCAATGGGAATTTAACG -> GTCAATGGGAATTTAACGT
ATTCAGATGAACATTCGGA -> TTCAGATGAACATTCGGAT
TGCGAAATACGAGATCGGC -> GCGAAATACGAGATCGGCA
GAGTTAGAATCAGGTGGGC -> AGTTAGAATCAGGTGGGCC
CGTGGGTCGCATTCAAAGA -> GTGGGTCGCATTCAAAGAG
AGTTAGAATCAGGTGGGCC -> GTTAGAATCAGGTGGGCCT
TCAGTGCCCAAACCGTCAG -> CAGTGCCCAAACCGTCAGG
TGCCTACTGACTGTCCGCC -> GCCTACTGACTGTCCGCCA
ACTGTCCGCCATGATCTTG -> CTGTCCGCCATGATCTTGC
CATTCAAAGAGAGAAACGC -> ATTCAAAGAGAGAAACGCT
GCTCTTCCTAGACATGGCA -> CTCTTCCTAGACATGGCAC
GTGATGAACATCCCCCTCG -> TGATGAACATCCCCCTCGT
TTAGCACTATAATGCTGTG -> TAGCACTATAATGCTGTGC
TAGTGCATCCGATGTCGGG -> AGTGCATCCGATGTCGGGA
TCCCGTTGAATAAGTGGGG -> CCCGTTGAATAAGTGGGGT
TGCGGTTTCACCGAGTGCC -> GCGGTTTCACCGAGTGCCG
TATGATCTTTAATACGATA -> ATGATCTTTAATACGATAC
GCCTGTCAGATTTCAGATG -> CCTGTCAGATTTCAGATGG
ATGGACGGCGTACCGATCT -> TGGACGGCGTACCGATCTG
CCGCTTCACAGAATATCAC -> CGCTTCACAGAATATCACA
AAGGTCTCGTCTTATGTGA -> AGGTCTCGTCTTATGTGAG
TCGTCGGGGGTCCGCTTCA -> CGTCGGGGGTCCGCTTCAC
TACCGTGCGATGACGGCTC -> ACCGTGCGATGACGGCTCC
ATAATATTATCAGCCGACC -> TAATATTATCAGCCGACCC
GTTCCTATTTCCCTCATGA -> TTCCTATTTCCCTCATGAG
GTCTGTTGCACCCCCTCGT -> TCTGTTGCACCCCCTCGTC
AACTCGCGTTTGAAGGTCT -> ACTCGCGTTTGAAGGTCTC
ACCAGCCGAGATGAGACAG -> CCAGCCGAGATGAGACAGG
AATATCACAATACGTCGGG -> ATATCACAATACGTCGGGG
TTACCAGGGTTTTCGTTCC -> TACCAGGGTTTTCGTTCCC
CATGGAGCTGACGGCTGGT -> ATGGAGCTGACGGCTGGTG
GTCAGTTCAGCGACATTAA -> TCAGTTCAGCGACATTAAA
AAGGTCTCCCGTTGAATAA -> AGGTCTCCCGTTGAATAAG
TACCAGGGTTTTCGTTCCC -> ACCAGGGTTTTCGTTCCCA
GCCGAGATGAGACAGGTTA -> CCGAGATGAGACAGGTTAA
TATCTGTTGACCCGTGGAC -> ATCTGTTGACCCGTGGACG
CCAGGGCATTCCCTGCTTG -> CAGGGCATTCCCTGCTTGG
TCCCCTTTGCATCGAATCA -> CCCCTTTGCATCGAATCAA
AATGGCTGGCCGTTCCTAT -> ATGGCTGGCCGTTCCTATT
