AAAAATCGTCT -> AAAATCGTCTC
AAAACACTTTA -> AAACACTTTAG
AAAACCGCTGT -> AAACCGCTGTC
AAAACGCTCGT -> AAACGCTCGTG
AAAACTTCATA -> AAACTTCATAA
AAAAGGCCGAC -> AAAGGCCGACG
AAAATACCGTT -> AAATACCGTTA
AAAATATTCGT -> AAATATTCGTA
AAAATCAAGTG -> AAATCAAGTGC
AAAATCGTCTC -> AAATCGTCTCT
AAAATTGCAGA -> AAATTGCAGAC
AAACACATCAA -> AACACATCAAC
AAACACTTTAG -> AACACTTTAGA
AAACAGCTCGC -> AACAGCTCGCT
AAACCGCTGTC -> AACCGCTGTCC
AAACGCTCGTG -> AACGCTCGTGT
AAACTGCTGAG -> AACTGCTGAGC
AAACTTAACGA -> AACTTAACGAT
AAACTTCATAA -> AACTTCATAAC
AAAGACCGTTA -> AAGACCGTTAT
AAAGCGGTTGG -> AAGCGGTTGGG
AAAGGCCGACG -> AAGGCCGACGG
AAAGGGATCTT -> AAGGGATCTTC
AAAGGGCGAAC -> AAGGGCGAACG
AAAGGTTAAGT -> AAGGTTAAGTC
AAAGTTTAACC -> AAGTTTAACCG
AAATAACAATA -> AATAACAATAC
AAATACCGTTA -> AATACCGTTAG
AAATAGGATTC -> AATAGGATTCG
AAATAGTCGTA -> AATAGTCGTAC
AAATATGAAGT -> AATATGAAGTG
AAATATTCGTA -> AATATTCGTAG
AAATCAAGTGC -> AATCAAGTGCT
AAATCATATGC -> AATCATATGCA
AAATCCTCCGT -> AATCCTCCGTT
AAATCGTCTCT -> AATCGTCTCTG
AAATGGGCCTC -> AATGGGCCTCC
AAATGTTGGCG -> AATGTTGGCGC
AAATTAGAGCC -> AATTAGAGCCA
AAATTCGTGCC -> AATTCGTGCCT
AAATTGCAGAC -> AATTGCAGACA
AACAAAATCAA -> ACAAAATCAAG
AACAAAGGGCG -> ACAAAGGGCGA
AACAATACCTG -> ACAATACCTGA
AACACATCAAC -> ACACATCAACG
AACACTTGAAA -> ACACTTGAAAA
AACACTTTAGA -> ACACTTTAGAA
AACAGCAGATT -> ACAGCAGATTT
AACAGCTCGCT -> ACAGCTCGCTA
AACAGGGATTG -> ACAGGGATTGG
AACAGTGGTTT -> ACAGTGGTTTG
AACAGTTTTTC -> ACAGTTTTTCG
AACCCATCGGC -> ACCCATCGGCT
AACCCTCACCT -> ACCCTCACCTT
AACCCTTTATG -> ACCCTTTATGA
AACCGCCTGTG -> ACCGCCTGTGC
AACCGCTGTCC -> ACCGCTGTCCG
AACCGTTGTCG -> ACCGTTGTCGC
AACGATTAATA -> ACGATTAATAC
AACGATTTAGG -> ACGATTTAGGA
AACGCAAGCCG -> ACGCAAGCCGT
AACGCTCGTGT -> ACGCTCGTGTG
AACGGACTAGG -> ACGGACTAGGA
AACGGATAGGG -> ACGGATAGGGT
AACGGCCTATC -> ACGGCCTATCG
AACGGGTCGAC -> ACGGGTCGACA
AACGTATTGCA -> ACGTATTGCAG
AACGTTCCATT -> ACGTTCCATTT
AACTACTTTCA -> ACTACTTTCAG
AACTCATCCAG -> ACTCATCCAGA
AACTCGCATTT -> ACTCGCATTTG
AACTGCTGAGC -> ACTGCTGAGCG
AACTGTATTCC -> ACTGTATTCCA
AACTTAACGAT -> ACTTAACGATT
AACTTCAGCCG -> ACTTCAGCCGC
AACTTCATAAC -> ACTTCATAACA
AACTTCGCGTG -> ACTTCGCGTGA
AACTTCGGCGA -> ACTTCGGCGAG
AACTTTAGTCG -> ACTTTAGTCGT
AAGACCGTTAT -> AGACCGTTATT
AAGACTTGTCA -> AGACTTGTCAC
AAGCAACTTCG -> AGCAACTTCGC
AAGCAGGATGA -> AGCAGGATGAA
AAGCCGTTGTC -> AGCCGTTGTCA
AAGCGCTAAAT -> AGCGCTAAATA
AAGCGGTTGGG -> AGCGGTTGGGC
AAGCTGGACTG -> AGCTGGACTGG
AAGGCCGACGG -> AGGCCGACGGT
AAGGCGCACAC -> AGGCGCACACT
AAGGGAACTCG -> AGGGAACTCGC
AAGGGATCTTC -> AGGGATCTTCG
AAGGGCGAACG -> AGGGCGAACGG
AAGGGTACATA -> AGGGTACATAG
AAGGGTATCCA -> AGGGTATCCAC
AAGGTCGACAA -> AGGTCGACAAT
AAGGTTAAGTC -> AGGTTAAGTCG
AAGTATGTCCA -> AGTATGTCCAA
AAGTCGAATCG -> AGTCGAATCGT
AAGTCGTGCAA -> AGTCGTGCAAG
AAGTCTAAAGG -> AGTCTAAAGGT
AAGTGCGTGCT -> AGTGCGTGCTA
AAGTGCTACGG -> AGTGCTACGGT
AAGTGCTCAAA -> AGTGCTCAAAT
AAGTTCATCGA -> AGTTCATCGAC
AAGTTTAACCG -> AGTTTAACCGC
AATAAATAACA -> ATAAATAACAA
AATAACAATAC -> ATAACAATACC
AATACATGAGG -> ATACATGAGGG
AATACCGGATG -> ATACCGGATGC
AATACCGTTAG -> ATACCGTTAGG
AATACCTGAGC -> ATACCTGAGCG
AATAGAAATTC -> ATAGAAATTCG
AATAGGATTCG -> ATAGGATTCGT
AATAGGGCAGC -> ATAGGGCAGCC
AATAGTCGTAC -> ATAGTCGTACT
AATATCGAACT -> ATATCGAACTA
AATATGAAGTG -> ATATGAAGTGC
AATATTCGTAG -> ATATTCGTAGT
AATCAAGTGCT -> ATCAAGTGCTC
AATCAGCTTTA -> ATCAGCTTTAC
AATCAGTAAGC -> ATCAGTAAGCA
AATCATATGCA -> ATCATATGCAT
AATCCGAGAAA -> ATCCGAGAAAA
AATCCTCCGTT -> ATCCTCCGTTT
AATCGTCTCTG -> ATCGTCTCTGA
AATCGTGCGGC -> ATCGTGCGGCT
AATGACATCAG -> ATGACATCAGT
AATGGACAACA -> ATGGACAACAA
AATGGGCCTCC -> ATGGGCCTCCA
AATGTTGGCGC -> ATGTTGGCGCC
AATTAGAGCCA -> ATTAGAGCCAC
AATTAGCATTA -> ATTAGCATTAC
AATTCGTGCCT -> ATTCGTGCCTC
AATTGCAGACA -> ATTGCAGACAA
AATTGTCATTA -> ATTGTCATTAT
ACAAAATCAAG -> CAAAATCAAGT
ACAAACTGCTG -> CAAACTGCTGA
ACAAAGGGCGA -> CAAAGGGCGAA
ACAAATAGGAT -> CAAATAGGATT
ACAAATTAGAG -> CAAATTAGAGC
ACAACAAAATC -> CAACAAAATCA
ACAACTTCAGC -> CAACTTCAGCC
ACAATAAATAA -> CAATAAATAAC
ACAATACCTGA -> CAATACCTGAG
ACACATCAACG -> CACATCAACGG
ACACCCAAATC -> CACCCAAATCA
ACACTAACAGC -> CACTAACAGCA
ACACTCGGAAC -> CACTCGGAACG
ACACTTGAAAA -> CACTTGAAAAG
ACACTTTAGAA -> CACTTTAGAAA
ACAGACGTGGC -> CAGACGTGGCA
ACAGCAGATTT -> CAGCAGATTTA
ACAGCTCGCTA -> CAGCTCGCTAT
ACAGGGATTGG -> CAGGGATTGGC
ACAGGGGTGGT -> CAGGGGTGGTC
ACAGGTCCGGT -> CAGGTCCGGTA
ACAGTACTCGT -> CAGTACTCGTG
ACAGTGGTTTG -> CAGTGGTTTGG
ACAGTTCATCA -> CAGTTCATCAG
ACAGTTCTAGC -> CAGTTCTAGCC
ACAGTTTTTCG -> CAGTTTTTCGA
ACATAGAAAGG -> CATAGAAAGGG
ACATCAACGGA -> CATCAACGGAT
ACATCAGTAAA -> CATCAGTAAAG
ACATGAGGGCT -> CATGAGGGCTT
ACATTTAACTC -> CATTTAACTCA
ACCATAACCCT -> CCATAACCCTC
ACCATCAACAA -> CCATCAACAAA
ACCCAAAGACC -> CCCAAAGACCG
ACCCAAATCAT -> CCCAAATCATA
ACCCACGATGT -> CCCACGATGTC
ACCCAGCCGAA -> CCCAGCCGAAA
ACCCATCGGCT -> CCCATCGGCTT
ACCCCACGCAA -> CCCCACGCAAC
ACCCCGTCAGT -> CCCCGTCAGTT
ACCCGCAGTTA -> CCCGCAGTTAA
ACCCGTGTCCT -> CCCGTGTCCTA
ACCCTCACCTT -> CCCTCACCTTC
ACCCTGCTGGA -> CCCTGCTGGAG
ACCCTTTATGA -> CCCTTTATGAA
ACCGCCTGTGC -> CCGCCTGTGCG
ACCGCGGGAGG -> CCGCGGGAGGC
ACCGCTGTCCG -> CCGCTGTCCGC
ACCGGAGAGAT -> CCGGAGAGATA
ACCGGATGCCC -> CCGGATGCCCG
ACCGGGCTACC -> CCGGGCTACCA
ACCGTTAGGAG -> CCGTTAGGAGT
ACCGTTATTTA -> CCGTTATTTAC
ACCGTTGTCGC -> CCGTTGTCGCG
ACCTAGAAGAC -> CCTAGAAGACT
ACCTGAGCGGG -> CCTGAGCGGGC
ACCTTCGATAG -> CCTTCGATAGG
ACCTTCGGTCG -> CCTTCGGTCGA
ACCTTGTACGT -> CCTTGTACGTC
ACGACGACTAC -> CGACGACTACC
ACGACTACCGG -> CGACTACCGGG
ACGACTCGAAG -> CGACTCGAAGC
ACGATGATCTA -> CGATGATCTAG
ACGATGTCAGC -> CGATGTCAGCA
ACGATTAATAC -> CGATTAATACA
ACGATTTAGGA -> CGATTTAGGAG
ACGCAACGTTC -> CGCAACGTTCC
ACGCAAGCCGT -> CGCAAGCCGTT
ACGCACATTTA -> CGCACATTTAA
ACGCCGACGCG -> CGCCGACGCGG
ACGCGGTAGTC -> CGCGGTAGTCG
ACGCTCGTGTG -> CGCTCGTGTGT
ACGCTGGGGCT -> CGCTGGGGCTG
ACGCTTGGGGC -> CGCTTGGGGCG
ACGGACTAGGA -> CGGACTAGGAG
ACGGATAGGGT -> CGGATAGGGTA
ACGGCCTATCG -> CGGCCTATCGC
ACGGGTCGACA -> CGGGTCGACAA
ACGGTATAGTG -> CGGTATAGTGC
ACGGTGTATGG -> CGGTGTATGGG
ACGTACGACGA -> CGTACGACGAC
ACGTATGTTCC -> CGTATGTTCCC
ACGTATTGCAG -> CGTATTGCAGA
ACGTCGCGTTC -> CGTCGCGTTCT
ACGTGACCTTG -> CGTGACCTTGT
ACGTGGCATAA -> CGTGGCATAAC
ACGTGGCCTTG -> CGTGGCCTTGA
ACGTTCCATTT -> CGTTCCATTTC
ACTAACAGCAG -> CTAACAGCAGA
ACTACCGGGCT -> CTACCGGGCTA
ACTACTCTTTT -> CTACTCTTTTT
ACTACTTTCAG -> CTACTTTCAGA
ACTAGGAGCAA -> CTAGGAGCAAT
ACTCACCCGCA -> CTCACCCGCAG
ACTCATCCAGA -> CTCATCCAGAC
ACTCCTCTAAG -> CTCCTCTAAGT
ACTCGAAGCAA -> CTCGAAGCAAC
ACTCGCATTTG -> CTCGCATTTGT
ACTCGCCATCC -> CTCGCCATCCT
ACTCGGAACGT -> CTCGGAACGTA
ACTCGTGGCTA -> CTCGTGGCTAC
ACTCTAACGGA -> CTCTAACGGAC
ACTCTTTTTTG -> CTCTTTTTTGT
ACTGCCGCAAA -> CTGCCGCAAAA
ACTGCTGAGCG -> CTGCTGAGCGT
ACTGCTTTTGT -> CTGCTTTTGTT
ACTGGCGCAGC -> CTGGCGCAGCG
ACTGGCGTGAG -> CTGGCGTGAGC
ACTGTATTCCA -> CTGTATTCCAA
ACTGTTACCCT -> CTGTTACCCTG
ACTTAACGATT -> CTTAACGATTA
ACTTATGGGGC -> CTTATGGGGCA
ACTTCAGCCGC -> CTTCAGCCGCT
ACTTCAGGTTC -> CTTCAGGTTCC
ACTTCATAACA -> CTTCATAACAG
ACTTCGCGTGA -> CTTCGCGTGAA
ACTTCGGCGAG -> CTTCGGCGAGA
ACTTGAAAAGG -> CTTGAAAAGGC
ACTTGTCACGC -> CTTGTCACGCT
ACTTTAGAAAT -> CTTTAGAAATG
ACTTTAGTCGT -> CTTTAGTCGTG
ACTTTCAGACC -> CTTTCAGACCC
AGAAAAATCGT -> GAAAAATCGTC
AGAAAACCGCT -> GAAAACCGCTG
AGAAAATTGCA -> GAAAATTGCAG
AGAAAGGGATC -> GAAAGGGATCT
AGAAATGTTGG -> GAAATGTTGGC
AGAAATTCGTG -> GAAATTCGTGC
AGAACTTCGGC -> GAACTTCGGCG
AGAACTTTAGT -> GAACTTTAGTC
AGAAGACTTGT -> GAAGACTTGTC
AGACAACTTCA -> GACAACTTCAG
AGACAGGTCCG -> GACAGGTCCGG
AGACCCCACGC -> GACCCCACGCA
AGACCGTTATT -> GACCGTTATTT
AGACGCACATT -> GACGCACATTT
AGACGTGGCAT -> GACGTGGCATA
AGACTGTTACC -> GACTGTTACCC
AGACTTGTCAC -> GACTTGTCACG
AGAGAGTAACT -> GAGAGTAACTG
AGAGATAGATA -> GAGATAGATAA
AGAGATTGTCC -> GAGATTGTCCG
AGAGCCACCTA -> GAGCCACCTAG
AGAGTAACTGT -> GAGTAACTGTA
AGATAACCCTT -> GATAACCCTTT
AGATAGATAAC -> GATAGATAACC
AGATTGTCCGT -> GATTGTCCGTA
AGATTTATCGC -> GATTTATCGCT
AGCAACAGTTT -> GCAACAGTTTT
AGCAACCCATC -> GCAACCCATCG
AGCAACTTCGC -> GCAACTTCGCG
AGCAAGCGCTA -> GCAAGCGCTAA
AGCAATATCGA -> GCAATATCGAA
AGCACCGCGGG -> GCACCGCGGGA
AGCAGATTTAT -> GCAGATTTATC
AGCAGGATGAA -> GCAGGATGAAA
AGCAGTAGTGT -> GCAGTAGTGTC
AGCATACTTCA -> GCATACTTCAG
AGCATTACAGA -> GCATTACAGAC
AGCCACCCAAA -> GCCACCCAAAG
AGCCACCTAGA -> GCCACCTAGAA
AGCCGAAAATA -> GCCGAAAATAC
AGCCGCTGCCT -> GCCGCTGCCTG
AGCCGTTGTCA -> GCCGTTGTCAT
AGCCTTACACC -> GCCTTACACCC
AGCGACAGGGG -> GCGACAGGGGT
AGCGCTAAATA -> GCGCTAAATAT
AGCGGAGAGAT -> GCGGAGAGATT
AGCGGGCCACG -> GCGGGCCACGT
AGCGGTTGGGC -> GCGGTTGGGCC
AGCGTCACTCC -> GCGTCACTCCT
AGCGTGACCGG -> GCGTGACCGGA
AGCTCGCTATA -> GCTCGCTATAG
AGCTGAGGGGA -> GCTGAGGGGAT
AGCTGGACTGG -> GCTGGACTGGC
AGCTGTTAACC -> GCTGTTAACCG
AGCTTTACGTA -> GCTTTACGTAT
AGGAATCCGAG -> GGAATCCGAGA
AGGACTGGCGT -> GGACTGGCGTG
AGGAGCAATAT -> GGAGCAATATC
AGGAGTCCACA -> GGAGTCCACAG
AGGAGTTGAGC -> GGAGTTGAGCA
AGGATGAAAGT -> GGATGAAAGTT
AGGATTCCCAC -> GGATTCCCACC
AGGATTCGTAT -> GGATTCGTATC
AGGCATGTCCT -> GGCATGTCCTG
AGGCCGACGGT -> GGCCGACGGTG
AGGCGCACACT -> GGCGCACACTC
AGGCGGTCGCT -> GGCGGTCGCTC
AGGGAACTCGC -> GGGAACTCGCA
AGGGATCTTCG -> GGGATCTTCGG
AGGGATTGGCC -> GGGATTGGCCT
AGGGCAGCCAC -> GGGCAGCCACC
AGGGCGAACGG -> GGGCGAACGGC
AGGGCTTTTCC -> GGGCTTTTCCC
AGGGGAATCAG -> GGGGAATCAGT
AGGGGATGGGG -> GGGGATGGGGT
AGGGGTGGTCG -> GGGGTGGTCGT
AGGGTACATAG -> GGGTACATAGA
AGGGTATAATG -> GGGTATAATGA
AGGGTATCCAC -> GGGTATCCACC
AGGTAGCATAC -> GGTAGCATACT
AGGTCATTTTC -> GGTCATTTTCT
AGGTCCGGTAG -> GGTCCGGTAGC
AGGTCGACAAT -> GGTCGACAATA
AGGTTAAGTCG -> GGTTAAGTCGA
AGGTTCCTAGG -> GGTTCCTAGGA
AGTAAAGCGGT -> GTAAAGCGGTT
AGTAACTGTAT -> GTAACTGTATT
AGTAAGCAGGA -> GTAAGCAGGAT
AGTACACTAAC -> GTACACTAACA
AGTACTCGTGG -> GTACTCGTGGC
AGTAGTGTCGG -> GTAGTGTCGGA
AGTATAAACTT -> GTATAAACTTA
AGTATGTCCAA -> GTATGTCCAAG
AGTCCACAGTT -> GTCCACAGTTC
AGTCGAATCGT -> GTCGAATCGTG
AGTCGACAAAC -> GTCGACAAACT
AGTCGTACTTA -> GTCGTACTTAT
AGTCGTCCACA -> GTCGTCCACAG
AGTCGTGCAAG -> GTCGTGCAAGG
AGTCGTGGTAT -> GTCGTGGTATA
AGTCTAAAGGT -> GTCTAAAGGTT
AGTGCGTGCTA -> GTGCGTGCTAA
AGTGCTACGGT -> GTGCTACGGTA
AGTGCTCAAAT -> GTGCTCAAATA
AGTGCTTCTTA -> GTGCTTCTTAT
AGTGGCGTGGT -> GTGGCGTGGTG
AGTGGTTTGGG -> GTGGTTTGGGA
AGTGTCGGATG -> GTGTCGGATGC
AGTTAAGGGTA -> GTTAAGGGTAC
AGTTAGAACTT -> GTTAGAACTTT
AGTTCACAGTA -> GTTCACAGTAC
AGTTCATCAGA -> GTTCATCAGAC
AGTTCATCGAC -> GTTCATCGACT
AGTTCATGTGT -> GTTCATGTGTT
AGTTCTAGCCT -> GTTCTAGCCTT
AGTTGAGCAGT -> GTTGAGCAGTA
AGTTGGTCTCA -> GTTGGTCTCAG
AGTTTAACCGC -> GTTTAACCGCC
AGTTTTTCGAA -> GTTTTTCGAAA
ATAAACTTAAC -> TAAACTTAACG
ATAAATAACAA -> TAAATAACAAT
ATAACAATACC -> TAACAATACCT
ATAACACTTGA -> TAACACTTGAA
ATAACAGGGAT -> TAACAGGGATT
ATAACAGTGGT -> TAACAGTGGTT
ATAACCCTCAC -> TAACCCTCACC
ATAACCCTTTA -> TAACCCTTTAT
ATAAGGTCGAC -> TAAGGTCGACA
ATAATAGAAAT -> TAATAGAAATT
ATAATCAGCTT -> TAATCAGCTTT
ATAATGACATC -> TAATGACATCA
ATACATGAGGG -> TACATGAGGGC
ATACCGGATGC -> TACCGGATGCC
ATACCGTTAGG -> TACCGTTAGGA
ATACCTGAGCG -> TACCTGAGCGG
ATACGCTGGGG -> TACGCTGGGGC
ATACTCTAACG -> TACTCTAACGG
ATACTTCAGGT -> TACTTCAGGTT
ATAGAAAGGGA -> TAGAAAGGGAT
ATAGAAATTCG -> TAGAAATTCGT
ATAGATAACCC -> TAGATAACCCT
ATAGCAACAGT -> TAGCAACAGTT
ATAGGATTCGT -> TAGGATTCGTA
ATAGGCGGTCG -> TAGGCGGTCGC
ATAGGGCAGCC -> TAGGGCAGCCA
ATAGGGTATAA -> TAGGGTATAAT
ATAGGTCATTT -> TAGGTCATTTT
ATAGTCGTACT -> TAGTCGTACTT
ATAGTGCTTCT -> TAGTGCTTCTT
ATAGTGGCGTG -> TAGTGGCGTGG
ATAGTTCACAG -> TAGTTCACAGT
ATATACTCTAA -> TATACTCTAAC
ATATCGAACTA -> TATCGAACTAC
ATATGAAGTGC -> TATGAAGTGCG
ATATGCATTCG -> TATGCATTCGC
ATATTCGTAGT -> TATTCGTAGTA
ATCAACAAAGG -> TCAACAAAGGG
ATCAACGGATA -> TCAACGGATAG
ATCAAGTGCTC -> TCAAGTGCTCA
ATCAGACGCAC -> TCAGACGCACA
ATCAGCTTTAC -> TCAGCTTTACG
ATCAGTAAAGC -> TCAGTAAAGCG
ATCAGTAAGCA -> TCAGTAAGCAG
ATCATATGCAT -> TCATATGCATT
ATCCACCATCA -> TCCACCATCAA
ATCCAGACAGG -> TCCAGACAGGT
ATCCGAGAAAA -> TCCGAGAAAAA
ATCCTCCGTTT -> TCCTCCGTTTC
ATCCTCTTAAT -> TCCTCTTAATT
ATCCTTATCGC -> TCCTTATCGCG
ATCGAACTACT -> TCGAACTACTT
ATCGACTCGCC -> TCGACTCGCCA
ATCGCGTGGAG -> TCGCGTGGAGA
ATCGCTCCGCG -> TCGCTCCGCGG
ATCGCTGGAAG -> TCGCTGGAAGT
ATCGGCTTCAC -> TCGGCTTCACG
ATCGTCTCTGA -> TCGTCTCTGAG
ATCGTGCGGCT -> TCGTGCGGCTC
ATCTAGCGGAG -> TCTAGCGGAGA
ATCTGGTTATT -> TCTGGTTATTG
ATCTGTCCCGA -> TCTGTCCCGAA
ATCTTCGGGTC -> TCTTCGGGTCC
ATGAAAGTTTA -> TGAAAGTTTAA
ATGAAGTGCGT -> TGAAGTGCGTG
ATGAAGTTCAT -> TGAAGTTCATC
ATGACATCAGT -> TGACATCAGTA
ATGACTCACCC -> TGACTCACCCG
ATGAGGGCTTT -> TGAGGGCTTTT
ATGATCTAGCG -> TGATCTAGCGG
ATGCAAGTGCT -> TGCAAGTGCTA
ATGCAGGATTC -> TGCAGGATTCC
ATGCATTCGCT -> TGCATTCGCTA
ATGCCCGCTGG -> TGCCCGCTGGC
ATGCCGTAGCA -> TGCCGTAGCAC
ATGCGTCCGAA -> TGCGTCCGAAT
ATGGACAACAA -> TGGACAACAAA
ATGGGCCTCCA -> TGGGCCTCCAA
ATGGGGCACCC -> TGGGGCACCCA
ATGGGGTCCAG -> TGGGGTCCAGT
ATGGGTCTTTT -> TGGGTCTTTTC
ATGTCAGCAAG -> TGTCAGCAAGC
ATGTCCAAGGG -> TGTCCAAGGGA
ATGTCCTGCCC -> TGTCCTGCCCT
ATGTGTTAACG -> TGTGTTAACGC
ATGTTCATAGT -> TGTTCATAGTG
ATGTTCCCATT -> TGTTCCCATTG
ATGTTGGCGCC -> TGTTGGCGCCC
ATTAACGGGTC -> TTAACGGGTCG
ATTAATACATG -> TTAATACATGA
ATTACAGACGT -> TTACAGACGTG
ATTAGAGCCAC -> TTAGAGCCACC
ATTAGCATTAC -> TTAGCATTACA
ATTATCTGGTT -> TTATCTGGTTA
ATTCCAAAACG -> TTCCAAAACGC
ATTCCCACCCG -> TTCCCACCCGT
ATTCGCTACAA -> TTCGCTACAAA
ATTCGTAGTAC -> TTCGTAGTACA
ATTCGTATCCT -> TTCGTATCCTT
ATTCGTGCCTC -> TTCGTGCCTCT
ATTGATAGCAA -> TTGATAGCAAC
ATTGCAGAACT -> TTGCAGAACTT
ATTGCAGACAA -> TTGCAGACAAC
ATTGCGTTTTG -> TTGCGTTTTGA
ATTGGCCTGCC -> TTGGCCTGCCC
ATTGTCATTAT -> TTGTCATTATC
ATTGTCCGTAA -> TTGTCCGTAAC
ATTTAACTCAT -> TTTAACTCATC
ATTTACGATGA -> TTTACGATGAT
ATTTAGGAGTT -> TTTAGGAGTTG
ATTTATCGCTG -> TTTATCGCTGG
ATTTCGCGGAT -> TTTCGCGGATA
ATTTGTCTTCC -> TTTGTCTTCCT
ATTTTCTCAGT -> TTTTCTCAGTT
CAAAACGCTCG -> AAAACGCTCGT
CAAAATATTCG -> AAAATATTCGT
CAAAATCAAGT -> AAAATCAAGTG
CAAACTGCTGA -> AAACTGCTGAG
CAAAGACCGTT -> AAAGACCGTTA
CAAAGGGCGAA -> AAAGGGCGAAC
CAAATAGGATT -> AAATAGGATTC
CAAATAGTCGT -> AAATAGTCGTA
CAAATCATATG -> AAATCATATGC
CAAATGGGCCT -> AAATGGGCCTC
CAAATTAGAGC -> AAATTAGAGCC
CAACAAAATCA -> AACAAAATCAA
CAACAAAGGGC -> AACAAAGGGCG
CAACAGTTTTT -> AACAGTTTTTC
CAACCCATCGG -> AACCCATCGGC
CAACGGATAGG -> AACGGATAGGG
CAACGTTCCAT -> AACGTTCCATT
CAACTTCAGCC -> AACTTCAGCCG
CAACTTCGCGT -> AACTTCGCGTG
CAAGCCGTTGT -> AAGCCGTTGTC
CAAGCGCTAAA -> AAGCGCTAAAT
CAAGGCGCACA -> AAGGCGCACAC
CAAGGGAACTC -> AAGGGAACTCG
CAAGGGTATCC -> AAGGGTATCCA
CAAGTGCTACG -> AAGTGCTACGG
CAAGTGCTCAA -> AAGTGCTCAAA
CAATAAATAAC -> AATAAATAACA
CAATACCGGAT -> AATACCGGATG
CAATACCTGAG -> AATACCTGAGC
CAATAGGGCAG -> AATAGGGCAGC
CAATATCGAAC -> AATATCGAACT
CACACTCGGAA -> ACACTCGGAAC
CACAGTACTCG -> ACAGTACTCGT
CACAGTTCATC -> ACAGTTCATCA
CACAGTTCTAG -> ACAGTTCTAGC
CACATCAACGG -> ACATCAACGGA
CACATTTAACT -> ACATTTAACTC
CACCATCAACA -> ACCATCAACAA
CACCCAAAGAC -> ACCCAAAGACC
CACCCAAATCA -> ACCCAAATCAT
CACCCACGATG -> ACCCACGATGT
CACCCGCAGTT -> ACCCGCAGTTA
CACCCGTGTCC -> ACCCGTGTCCT
CACCGCGGGAG -> ACCGCGGGAGG
CACCTAGAAGA -> ACCTAGAAGAC
CACCTTCGATA -> ACCTTCGATAG
CACCTTCGGTC -> ACCTTCGGTCG
CACGATGTCAG -> ACGATGTCAGC
CACGCAACGTT -> ACGCAACGTTC
CACGCTTGGGG -> ACGCTTGGGGC
CACGTACGACG -> ACGTACGACGA
CACGTGGCCTT -> ACGTGGCCTTG
CACTAACAGCA -> ACTAACAGCAG
CACTCCTCTAA -> ACTCCTCTAAG
CACTCGGAACG -> ACTCGGAACGT
CACTTGAAAAG -> ACTTGAAAAGG
CACTTTAGAAA -> ACTTTAGAAAT
CAGAACTTCGG -> AGAACTTCGGC
CAGACAACTTC -> AGACAACTTCA
CAGACAGGTCC -> AGACAGGTCCG
CAGACCCCACG -> AGACCCCACGC
CAGACGCACAT -> AGACGCACATT
CAGACGTGGCA -> AGACGTGGCAT
CAGACTGTTAC -> AGACTGTTACC
CAGATTTATCG -> AGATTTATCGC
CAGCAAGCGCT -> AGCAAGCGCTA
CAGCAGATTTA -> AGCAGATTTAT
CAGCCACCCAA -> AGCCACCCAAA
CAGCCGAAAAT -> AGCCGAAAATA
CAGCCGCTGCC -> AGCCGCTGCCT
CAGCGACAGGG -> AGCGACAGGGG
CAGCTCGCTAT -> AGCTCGCTATA
CAGCTTTACGT -> AGCTTTACGTA
CAGGATGAAAG -> AGGATGAAAGT
CAGGATTCCCA -> AGGATTCCCAC
CAGGGATTGGC -> AGGGATTGGCC
CAGGGGTGGTC -> AGGGGTGGTCG
CAGGTCCGGTA -> AGGTCCGGTAG
CAGGTTCCTAG -> AGGTTCCTAGG
CAGTAAAGCGG -> AGTAAAGCGGT
CAGTAAGCAGG -> AGTAAGCAGGA
CAGTACTCGTG -> AGTACTCGTGG
CAGTAGTGTCG -> AGTAGTGTCGG
CAGTCGTCCAC -> AGTCGTCCACA
CAGTGGTTTGG -> AGTGGTTTGGG
CAGTTAAGGGT -> AGTTAAGGGTA
CAGTTCATCAG -> AGTTCATCAGA
CAGTTCATGTG -> AGTTCATGTGT
CAGTTCTAGCC -> AGTTCTAGCCT
CAGTTGGTCTC -> AGTTGGTCTCA
CAGTTTTTCGA -> AGTTTTTCGAA
CATAACACTTG -> ATAACACTTGA
CATAACAGGGA -> ATAACAGGGAT
CATAACAGTGG -> ATAACAGTGGT
CATAACCCTCA -> ATAACCCTCAC
CATAATAGAAA -> ATAATAGAAAT
CATACTTCAGG -> ATACTTCAGGT
CATAGAAAGGG -> ATAGAAAGGGA
CATAGTGGCGT -> ATAGTGGCGTG
CATATGCATTC -> ATATGCATTCG
CATCAACAAAG -> ATCAACAAAGG
CATCAACGGAT -> ATCAACGGATA
CATCAGACGCA -> ATCAGACGCAC
CATCAGTAAAG -> ATCAGTAAAGC
CATCCAGACAG -> ATCCAGACAGG
CATCCTCTTAA -> ATCCTCTTAAT
CATCGACTCGC -> ATCGACTCGCC
CATCGGCTTCA -> ATCGGCTTCAC
CATGAGGGCTT -> ATGAGGGCTTT
CATGTCCTGCC -> ATGTCCTGCCC
CATGTGTTAAC -> ATGTGTTAACG
CATGTTCATAG -> ATGTTCATAGT
CATTACAGACG -> ATTACAGACGT
CATTATCTGGT -> ATTATCTGGTT
CATTCGCTACA -> ATTCGCTACAA
CATTGCGTTTT -> ATTGCGTTTTG
CATTTAACTCA -> ATTTAACTCAT
CATTTCGCGGA -> ATTTCGCGGAT
CATTTGTCTTC -> ATTTGTCTTCC
CATTTTCTCAG -> ATTTTCTCAGT
CCAAAACGCTC -> CAAAACGCTCG
CCAAAGACCGT -> CAAAGACCGTT
CCAAATCATAT -> CAAATCATATG
CCAAGGCGCAC -> CAAGGCGCACA
CCAAGGGAACT -> CAAGGGAACTC
CCACAGTTCAT -> CACAGTTCATC
CCACAGTTCTA -> CACAGTTCTAG
CCACCATCAAC -> CACCATCAACA
CCACCCAAAGA -> CACCCAAAGAC
CCACCCGTGTC -> CACCCGTGTCC
CCACCTAGAAG -> CACCTAGAAGA
CCACCTTCGGT -> CACCTTCGGTC
CCACGATGTCA -> CACGATGTCAG
CCACGCAACGT -> CACGCAACGTT
CCACGTGGCCT -> CACGTGGCCTT
CCAGACAGGTC -> CAGACAGGTCC
CCAGCCGAAAA -> CAGCCGAAAAT
CCAGTCGTCCA -> CAGTCGTCCAC
CCATAACACTT -> CATAACACTTG
CCATAACCCTC -> CATAACCCTCA
CCATCAACAAA -> CATCAACAAAG
CCATCCTCTTA -> CATCCTCTTAA
CCATCGGCTTC -> CATCGGCTTCA
CCATTGCGTTT -> CATTGCGTTTT
CCATTTCGCGG -> CATTTCGCGGA
CCCAAAGACCG -> CCAAAGACCGT
CCCAAATCATA -> CCAAATCATAT
CCCACCCGTGT -> CCACCCGTGTC
CCCACCTTCGG -> CCACCTTCGGT
CCCACGATGTC -> CCACGATGTCA
CCCACGCAACG -> CCACGCAACGT
CCCAGCCGAAA -> CCAGCCGAAAA
CCCATCGGCTT -> CCATCGGCTTC
CCCATTGCGTT -> CCATTGCGTTT
CCCCACGCAAC -> CCCACGCAACG
CCCCGTCAGTT -> CCCGTCAGTTG
CCCGAAGCTGG -> CCGAAGCTGGA
CCCGCAGTTAA -> CCGCAGTTAAG
CCCGCCGGGCA -> CCGCCGGGCAA
CCCGCTCATGT -> CCGCTCATGTT
CCCGCTGGCGA -> CCGCTGGCGAC
CCCGTCAGTTG -> CCGTCAGTTGG
CCCGTGACTAC -> CCGTGACTACT
CCCGTGTCCTA -> CCGTGTCCTAA
CCCTCACCTTC -> CCTCACCTTCG
CCCTGCTGGAG -> CCTGCTGGAGG
CCCTTGTTTTA -> CCTTGTTTTAT
CCCTTTATGAA -> CCTTTATGAAG
CCGAAAATACC -> CGAAAATACCG
CCGAAGCTGGA -> CGAAGCTGGAC
CCGAATGGACA -> CGAATGGACAA
CCGACGCGGTA -> CGACGCGGTAG
CCGACGGTGTA -> CGACGGTGTAT
CCGAGAAAAAT -> CGAGAAAAATC
CCGATAGGTCA -> CGATAGGTCAT
CCGCAAAATAT -> CGCAAAATATT
CCGCAGTTAAG -> CGCAGTTAAGG
CCGCCGGGCAA -> CGCCGGGCAAT
CCGCCTGTGCG -> CGCCTGTGCGG
CCGCGGGAGCT -> CGCGGGAGCTG
CCGCGGGAGGC -> CGCGGGAGGCA
CCGCGTCTCTA -> CGCGTCTCTAT
CCGCTCATGTT -> CGCTCATGTTC
CCGCTGCCTGT -> CGCTGCCTGTC
CCGCTGGCGAC -> CGCTGGCGACT
CCGCTGTCCGC -> CGCTGTCCGCG
CCGGAGAGATA -> CGGAGAGATAG
CCGGATGCCCG -> CGGATGCCCGC
CCGGGCAATAC -> CGGGCAATACC
CCGGGCTACCA -> CGGGCTACCAT
CCGGGCTTGGG -> CGGGCTTGGGG
CCGGTAGCAAC -> CGGTAGCAACC
CCGTAACGGAG -> CGTAACGGAGG
CCGTAGCACCG -> CGTAGCACCGC
CCGTCAGTTGG -> CGTCAGTTGGT
CCGTGACTACT -> CGTGACTACTC
CCGTGTCCTAA -> CGTGTCCTAAA
CCGTTAGGAGT -> CGTTAGGAGTC
CCGTTATTTAC -> CGTTATTTACG
CCGTTGTCATA -> CGTTGTCATAA
CCGTTGTCGCG -> CGTTGTCGCGG
CCGTTTCCTTA -> CGTTTCCTTAA
CCTAAAACTTC -> CTAAAACTTCA
CCTAGAAGACT -> CTAGAAGACTT
CCTAGGAATCC -> CTAGGAATCCG
CCTATCGCTCC -> CTATCGCTCCG
CCTCACCTTCG -> CTCACCTTCGA
CCTCCAAGGCG -> CTCCAAGGCGC
CCTCCGTTTCC -> CTCCGTTTCCT
CCTCTAAGTAT -> CTCTAAGTATG
CCTCTATCTGT -> CTCTATCTGTC
CCTCTTAATTA -> CTCTTAATTAG
CCTGAGCGGGC -> CTGAGCGGGCC
CCTGCCCACCT -> CTGCCCACCTT
CCTGCCCTTGT -> CTGCCCTTGTT
CCTGCTGGAGG -> CTGCTGGAGGT
CCTGTCGTGCT -> CTGTCGTGCTC
CCTGTGCGGTA -> CTGTGCGGTAC
CCTTAAACAGC -> CTTAAACAGCT
CCTTACACCCA -> CTTACACCCAA
CCTTACGACTC -> CTTACGACTCG
CCTTATCGCGT -> CTTATCGCGTG
CCTTCGATAGG -> CTTCGATAGGC
CCTTCGGTCGA -> CTTCGGTCGAG
CCTTGAAGTCG -> CTTGAAGTCGT
CCTTGTACGTC -> CTTGTACGTCG
CCTTGTTTTAT -> CTTGTTTTATA
CCTTTATGAAG -> CTTTATGAAGT
CGAAAACACTT -> GAAAACACTTT
CGAAAATACCG -> GAAAATACCGT
CGAACGGCCTA -> GAACGGCCTAT
CGAACTACTTT -> GAACTACTTTC
CGAAGCAACTT -> GAAGCAACTTC
CGAAGCTGGAC -> GAAGCTGGACT
CGAATCGTGCG -> GAATCGTGCGG
CGAATGGACAA -> GAATGGACAAC
CGACAAACTGC -> GACAAACTGCT
CGACAAATAGG -> GACAAATAGGA
CGACAATAAAT -> GACAATAAATA
CGACAGGGGTG -> GACAGGGGTGG
CGACGACTACC -> GACGACTACCG
CGACGCGGTAG -> GACGCGGTAGT
CGACGGTGTAT -> GACGGTGTATG
CGACTACCGGG -> GACTACCGGGC
CGACTCGAAGC -> GACTCGAAGCA
CGACTCGCCAT -> GACTCGCCATC
CGACTGCCGCA -> GACTGCCGCAA
CGAGAAAAATC -> GAGAAAAATCG
CGAGAGAGTAA -> GAGAGAGTAAC
CGAGCTGTTAA -> GAGCTGTTAAC
CGAGGACTGGC -> GAGGACTGGCG
CGATAGGCGGT -> GATAGGCGGTC
CGATAGGTCAT -> GATAGGTCATT
CGATGATCTAG -> GATGATCTAGC
CGATGTCAGCA -> GATGTCAGCAA
CGATTAATACA -> GATTAATACAT
CGATTTAGGAG -> GATTTAGGAGT
CGCAAAATATT -> GCAAAATATTC
CGCAACGTTCC -> GCAACGTTCCA
CGCAAGCCGTT -> GCAAGCCGTTG
CGCACACTCGG -> GCACACTCGGA
CGCACATTTAA -> GCACATTTAAC
CGCAGCGACAG -> GCAGCGACAGG
CGCAGTTAAGG -> GCAGTTAAGGG
CGCATTTGTCT -> GCATTTGTCTT
CGCCATAACAC -> GCCATAACACT
CGCCATCCTCT -> GCCATCCTCTT
CGCCCGTGACT -> GCCCGTGACTA
CGCCGACGCGG -> GCCGACGCGGT
CGCCGGGCAAT -> GCCGGGCAATA
CGCCTGTGCGG -> GCCTGTGCGGT
CGCGGATACGC -> GCGGATACGCT
CGCGGATATAC -> GCGGATATACT
CGCGGGAGCTG -> GCGGGAGCTGA
CGCGGGAGGCA -> GCGGGAGGCAT
CGCGGTAGTCG -> GCGGTAGTCGA
CGCGTCTCTAT -> GCGTCTCTATG
CGCGTGAACGA -> GCGTGAACGAT
CGCGTGGAGAA -> GCGTGGAGAAA
CGCGTTCTCGC -> GCGTTCTCGCT
CGCTAAATATG -> GCTAAATATGA
CGCTACAAATT -> GCTACAAATTA
CGCTATAGTTC -> GCTATAGTTCA
CGCTCATGTTC -> GCTCATGTTCA
CGCTCCGCGGG -> GCTCCGCGGGA
CGCTCGTGTGT -> GCTCGTGTGTC
CGCTCTTGTGT -> GCTCTTGTGTA
CGCTGCCTGTC -> GCTGCCTGTCG
CGCTGGAAGTC -> GCTGGAAGTCT
CGCTGGCGACT -> GCTGGCGACTG
CGCTGGCTCTG -> GCTGGCTCTGT
CGCTGGGGCTG -> GCTGGGGCTGA
CGCTGTCCGCG -> GCTGTCCGCGT
CGCTTGGGGCG -> GCTTGGGGCGT
CGGAACGTATT -> GGAACGTATTG
CGGACTAGGAG -> GGACTAGGAGC
CGGAGAGATAG -> GGAGAGATAGA
CGGAGAGATTG -> GGAGAGATTGT
CGGATACGCTG -> GGATACGCTGG
CGGATAGGGTA -> GGATAGGGTAT
CGGATATACTC -> GGATATACTCT
CGGATGCAAGT -> GGATGCAAGTG
CGGATGCCCGC -> GGATGCCCGCT
CGGCCTATCGC -> GGCCTATCGCT
CGGCGAGAGAG -> GGCGAGAGAGT
CGGCTCGAGGA -> GGCTCGAGGAC
CGGCTTCACGT -> GGCTTCACGTA
CGGGAGCTGAG -> GGGAGCTGAGG
CGGGAGGCATG -> GGGAGGCATGT
CGGGCAATACC -> GGGCAATACCG
CGGGCCACGTG -> GGGCCACGTGG
CGGGCTACCAT -> GGGCTACCATA
CGGGCTTGGGG -> GGGCTTGGGGT
CGGGTCCCGCT -> GGGTCCCGCTC
CGGGTCGACAA -> GGGTCGACAAA
CGGTACCCCGT -> GGTACCCCGTC
CGGTAGCAACC -> GGTAGCAACCC
CGGTAGTCGAC -> GGTAGTCGACA
CGGTATAGTGC -> GGTATAGTGCT
CGGTCGAGCTG -> GGTCGAGCTGT
CGGTCGCTCTT -> GGTCGCTCTTG
CGGTGTATGGG -> GGTGTATGGGT
CGGTTGGGCCG -> GGTTGGGCCGG
CGTAACGGAGG -> GTAACGGAGGT
CGTACGACGAC -> GTACGACGACT
CGTACTTATGG -> GTACTTATGGG
CGTAGCACCGC -> GTAGCACCGCG
CGTAGTACACT -> GTAGTACACTA
CGTATCCTTAT -> GTATCCTTATC
CGTATGTTCCC -> GTATGTTCCCA
CGTATTGCAGA -> GTATTGCAGAA
CGTCACTCCTC -> GTCACTCCTCT
CGTCAGTTGGT -> GTCAGTTGGTC
CGTCCACAGTT -> GTCCACAGTTC
CGTCCGAATGG -> GTCCGAATGGA
CGTCGCCATAA -> GTCGCCATAAC
CGTCGCGTTCT -> GTCGCGTTCTC
CGTCGTCGCCA -> GTCGTCGCCAT
CGTCTCTATGC -> GTCTCTATGCG
CGTCTCTGAGA -> GTCTCTGAGAA
CGTGAACGATT -> GTGAACGATTT
CGTGACCGGAG -> GTGACCGGAGA
CGTGACCTTGT -> GTGACCTTGTA
CGTGACTACTC -> GTGACTACTCT
CGTGAGCGTCA -> GTGAGCGTCAC
CGTGAGTATAA -> GTGAGTATAAA
CGTGCAAGGGT -> GTGCAAGGGTA
CGTGCCTCTAT -> GTGCCTCTATC
CGTGCGGCTCG -> GTGCGGCTCGA
CGTGCTAAATC -> GTGCTAAATCC
CGTGCTCAAAT -> GTGCTCAAATG
CGTGGAGAAAA -> GTGGAGAAAAC
CGTGGCATAAC -> GTGGCATAACA
CGTGGCCTTGA -> GTGGCCTTGAA
CGTGGCTACGC -> GTGGCTACGCC
CGTGGTATAAG -> GTGGTATAAGG
CGTGGTGGCGT -> GTGGTGGCGTG
CGTGTCCTAAA -> GTGTCCTAAAA
CGTGTGTCTAA -> GTGTGTCTAAT
CGTTAGGAGTC -> GTTAGGAGTCC
CGTTATTTACG -> GTTATTTACGA
CGTTCCATTTC -> GTTCCATTTCG
CGTTCTCGCTG -> GTTCTCGCTGG
CGTTGAAACAC -> GTTGAAACACA
CGTTGTCATAA -> GTTGTCATAAT
CGTTGTCGCGG -> GTTGTCGCGGA
CGTTTCCTTAA -> GTTTCCTTAAA
CGTTTTGAGGG -> GTTTTGAGGGG
CTAAAACTTCA -> TAAAACTTCAT
CTAAAGGTTAA -> TAAAGGTTAAG
CTAAATATGAA -> TAAATATGAAG
CTAAATCCTCC -> TAAATCCTCCG
CTAACAGCAGA -> TAACAGCAGAT
CTAACGGACTA -> TAACGGACTAG
CTAAGTATGTC -> TAAGTATGTCC
CTAATTGTCAT -> TAATTGTCATT
CTACAAATTAG -> TACAAATTAGA
CTACCATAACC -> TACCATAACCC
CTACCGGGCTA -> TACCGGGCTAC
CTACGCCGACG -> TACGCCGACGC
CTACGGTATAG -> TACGGTATAGT
CTACTCTTTTT -> TACTCTTTTTT
CTACTTTCAGA -> TACTTTCAGAC
CTAGAAGACTT -> TAGAAGACTTG
CTAGCCTTACA -> TAGCCTTACAC
CTAGCGGAGAG -> TAGCGGAGAGA
CTAGGAATCCG -> TAGGAATCCGA
CTAGGAGCAAT -> TAGGAGCAATA
CTATAGTTCAC -> TATAGTTCACA
CTATCGCTCCG -> TATCGCTCCGC
CTATCTGTCCC -> TATCTGTCCCG
CTATGCGTCCG -> TATGCGTCCGA
CTCAAATAGTC -> TCAAATAGTCG
CTCAAATGGGC -> TCAAATGGGCC
CTCACCCGCAG -> TCACCCGCAGT
CTCACCTTCGA -> TCACCTTCGAT
CTCAGACTGTT -> TCAGACTGTTA
CTCAGTTCATG -> TCAGTTCATGT
CTCATCCAGAC -> TCATCCAGACA
CTCATGTTCAT -> TCATGTTCATA
CTCCAAGGCGC -> TCCAAGGCGCA
CTCCGATAGGT -> TCCGATAGGTC
CTCCGCGGGAG -> TCCGCGGGAGC
CTCCGTTTCCT -> TCCGTTTCCTT
CTCCTCTAAGT -> TCCTCTAAGTA
CTCGAAGCAAC -> TCGAAGCAACT
CTCGAGGACTG -> TCGAGGACTGG
CTCGCATTTGT -> TCGCATTTGTC
CTCGCCATCCT -> TCGCCATCCTC
CTCGCTATAGT -> TCGCTATAGTT
CTCGCTGGCTC -> TCGCTGGCTCT
CTCGGAACGTA -> TCGGAACGTAT
CTCGTGGCTAC -> TCGTGGCTACG
CTCGTGTGTCT -> TCGTGTGTCTA
CTCTAACGGAC -> TCTAACGGACT
CTCTAAGTATG -> TCTAAGTATGT
CTCTATCTGTC -> TCTATCTGTCC
CTCTATGCGTC -> TCTATGCGTCC
CTCTGAGAAAA -> TCTGAGAAAAT
CTCTGTACCCA -> TCTGTACCCAG
CTCTTAATTAG -> TCTTAATTAGC
CTCTTGTGTAT -> TCTTGTGTATG
CTCTTTTTTGT -> TCTTTTTTGTG
CTGACGTGACC -> TGACGTGACCT
CTGAGAAAATT -> TGAGAAAATTG
CTGAGCGGGCC -> TGAGCGGGCCA
CTGAGCGTGAC -> TGAGCGTGACC
CTGAGGGGATG -> TGAGGGGATGG
CTGCCCACCTT -> TGCCCACCTTC
CTGCCCTTGTT -> TGCCCTTGTTT
CTGCCGCAAAA -> TGCCGCAAAAT
CTGCCTGTCGT -> TGCCTGTCGTG
CTGCTGAGCGT -> TGCTGAGCGTG
CTGCTGGAGGT -> TGCTGGAGGTA
CTGCTTTTGTT -> TGCTTTTGTTT
CTGGAAGTCTA -> TGGAAGTCTAA
CTGGACTGGCG -> TGGACTGGCGC
CTGGAGGTAGC -> TGGAGGTAGCA
CTGGCGACTGC -> TGGCGACTGCC
CTGGCGCAGCG -> TGGCGCAGCGA
CTGGCGTGAGC -> TGGCGTGAGCG
CTGGCTCTGTA -> TGGCTCTGTAC
CTGGGGCTGAC -> TGGGGCTGACG
CTGGTTATTGA -> TGGTTATTGAT
CTGTACCCAGC -> TGTACCCAGCC
CTGTATTCCAA -> TGTATTCCAAA
CTGTCCCGAAG -> TGTCCCGAAGC
CTGTCCGCGTC -> TGTCCGCGTCT
CTGTCGTGCTC -> TGTCGTGCTCA
CTGTGCGGTAC -> TGTGCGGTACC
CTGTTAACCGT -> TGTTAACCGTT
CTGTTACCCTG -> TGTTACCCTGC
CTTAAACAGCT -> TTAAACAGCTC
CTTAACGATTA -> TTAACGATTAA
CTTAATTAGCA -> TTAATTAGCAT
CTTACACCCAA -> TTACACCCAAA
CTTACGACTCG -> TTACGACTCGA
CTTATCGCGTG -> TTATCGCGTGG
CTTATGGGGCA -> TTATGGGGCAC
CTTATTAACGG -> TTATTAACGGG
CTTCACGTACG -> TTCACGTACGA
CTTCAGCCGCT -> TTCAGCCGCTG
CTTCAGGTTCC -> TTCAGGTTCCT
CTTCATAACAG -> TTCATAACAGT
CTTCCTTACGA -> TTCCTTACGAC
CTTCGATAGGC -> TTCGATAGGCG
CTTCGCGTGAA -> TTCGCGTGAAC
CTTCGGCGAGA -> TTCGGCGAGAG
CTTCGGGTCCC -> TTCGGGTCCCG
CTTCGGTCGAG -> TTCGGTCGAGC
CTTCTTATTAA -> TTCTTATTAAC
CTTGAAAAGGC -> TTGAAAAGGCC
CTTGAAGTCGT -> TTGAAGTCGTG
CTTGGGGCGTC -> TTGGGGCGTCG
CTTGGGGTATG -> TTGGGGTATGC
CTTGTACGTCG -> TTGTACGTCGC
CTTGTCACGCT -> TTGTCACGCTT
CTTGTGTATGC -> TTGTGTATGCA
CTTGTTTTATA -> TTGTTTTATAA
CTTTACGTATG -> TTTACGTATGT
CTTTAGAAATG -> TTTAGAAATGT
CTTTAGTCGTG -> TTTAGTCGTGG
CTTTATGAAGT -> TTTATGAAGTT
CTTTCAGACCC -> TTTCAGACCCC
CTTTTCCCGCC -> TTTTCCCGCCG
CTTTTCTCCGA -> TTTTCTCCGAT
CTTTTGTTTGG -> TTTTGTTTGGG
CTTTTTTGTGC -> TTTTTTGTGCA
GAAAAATCGTC -> AAAAATCGTCT
GAAAACACTTT -> AAAACACTTTA
GAAAACCGCTG -> AAAACCGCTGT
GAAAAGGCCGA -> AAAAGGCCGAC
GAAAATACCGT -> AAAATACCGTT
GAAAATTGCAG -> AAAATTGCAGA
GAAACACATCA -> AAACACATCAA
GAAAGGGATCT -> AAAGGGATCTT
GAAAGTTTAAC -> AAAGTTTAACC
GAAATGTTGGC -> AAATGTTGGCG
GAAATTCGTGC -> AAATTCGTGCC
GAACGATTTAG -> AACGATTTAGG
GAACGGCCTAT -> AACGGCCTATC
GAACGTATTGC -> AACGTATTGCA
GAACTACTTTC -> AACTACTTTCA
GAACTCGCATT -> AACTCGCATTT
GAACTTCGGCG -> AACTTCGGCGA
GAACTTTAGTC -> AACTTTAGTCG
GAAGACTTGTC -> AAGACTTGTCA
GAAGCAACTTC -> AAGCAACTTCG
GAAGCTGGACT -> AAGCTGGACTG
GAAGTCGTGCA -> AAGTCGTGCAA
GAAGTCTAAAG -> AAGTCTAAAGG
GAAGTGCGTGC -> AAGTGCGTGCT
GAAGTTCATCG -> AAGTTCATCGA
GAATCAGTAAG -> AATCAGTAAGC
GAATCCGAGAA -> AATCCGAGAAA
GAATCGTGCGG -> AATCGTGCGGC
GAATGGACAAC -> AATGGACAACA
GACAAACTGCT -> ACAAACTGCTG
GACAAATAGGA -> ACAAATAGGAT
GACAACAAAAT -> ACAACAAAATC
GACAACTTCAG -> ACAACTTCAGC
GACAATAAATA -> ACAATAAATAA
GACAGGGGTGG -> ACAGGGGTGGT
GACAGGTCCGG -> ACAGGTCCGGT
GACATCAGTAA -> ACATCAGTAAA
GACCCCACGCA -> ACCCCACGCAA
GACCGGAGAGA -> ACCGGAGAGAT
GACCGTTATTT -> ACCGTTATTTA
GACCTTGTACG -> ACCTTGTACGT
GACGACTACCG -> ACGACTACCGG
GACGCACATTT -> ACGCACATTTA
GACGCGGTAGT -> ACGCGGTAGTC
GACGGTGTATG -> ACGGTGTATGG
GACGTGACCTT -> ACGTGACCTTG
GACGTGGCATA -> ACGTGGCATAA
GACTACCGGGC -> ACTACCGGGCT
GACTACTCTTT -> ACTACTCTTTT
GACTAGGAGCA -> ACTAGGAGCAA
GACTCACCCGC -> ACTCACCCGCA
GACTCGAAGCA -> ACTCGAAGCAA
GACTCGCCATC -> ACTCGCCATCC
GACTGCCGCAA -> ACTGCCGCAAA
GACTGCTTTTG -> ACTGCTTTTGT
GACTGGCGCAG -> ACTGGCGCAGC
GACTGGCGTGA -> ACTGGCGTGAG
GACTGTTACCC -> ACTGTTACCCT
GACTTGTCACG -> ACTTGTCACGC
GAGAAAAATCG -> AGAAAAATCGT
GAGAAAACCGC -> AGAAAACCGCT
GAGAAAATTGC -> AGAAAATTGCA
GAGAGAGTAAC -> AGAGAGTAACT
GAGAGATAGAT -> AGAGATAGATA
GAGAGATTGTC -> AGAGATTGTCC
GAGAGTAACTG -> AGAGTAACTGT
GAGATAGATAA -> AGATAGATAAC
GAGATTGTCCG -> AGATTGTCCGT
GAGCAATATCG -> AGCAATATCGA
GAGCAGTAGTG -> AGCAGTAGTGT
GAGCCACCTAG -> AGCCACCTAGA
GAGCGGGCCAC -> AGCGGGCCACG
GAGCGTCACTC -> AGCGTCACTCC
GAGCGTGACCG -> AGCGTGACCGG
GAGCTGAGGGG -> AGCTGAGGGGA
GAGCTGTTAAC -> AGCTGTTAACC
GAGGACTGGCG -> AGGACTGGCGT
GAGGCATGTCC -> AGGCATGTCCT
GAGGGCTTTTC -> AGGGCTTTTCC
GAGGGGAATCA -> AGGGGAATCAG
GAGGGGATGGG -> AGGGGATGGGG
GAGGTAGCATA -> AGGTAGCATAC
GAGTAACTGTA -> AGTAACTGTAT
GAGTATAAACT -> AGTATAAACTT
GAGTCCACAGT -> AGTCCACAGTT
GAGTTAGAACT -> AGTTAGAACTT
GAGTTGAGCAG -> AGTTGAGCAGT
GATAACCCTTT -> ATAACCCTTTA
GATACGCTGGG -> ATACGCTGGGG
GATAGATAACC -> ATAGATAACCC
GATAGCAACAG -> ATAGCAACAGT
GATAGGCGGTC -> ATAGGCGGTCG
GATAGGGTATA -> ATAGGGTATAA
GATAGGTCATT -> ATAGGTCATTT
GATATACTCTA -> ATATACTCTAA
GATCTAGCGGA -> ATCTAGCGGAG
GATCTTCGGGT -> ATCTTCGGGTC
GATGAAAGTTT -> ATGAAAGTTTA
GATGACTCACC -> ATGACTCACCC
GATGATCTAGC -> ATGATCTAGCG
GATGCAAGTGC -> ATGCAAGTGCT
GATGCCCGCTG -> ATGCCCGCTGG
GATGGGGTCCA -> ATGGGGTCCAG
GATGTCAGCAA -> ATGTCAGCAAG
GATTAATACAT -> ATTAATACATG
GATTCCCACCC -> ATTCCCACCCG
GATTCGTATCC -> ATTCGTATCCT
GATTGGCCTGC -> ATTGGCCTGCC
GATTGTCCGTA -> ATTGTCCGTAA
GATTTAGGAGT -> ATTTAGGAGTT
GATTTATCGCT -> ATTTATCGCTG
GCAAAATATTC -> CAAAATATTCG
GCAACAGTTTT -> CAACAGTTTTT
GCAACCCATCG -> CAACCCATCGG
GCAACGTTCCA -> CAACGTTCCAT
GCAACTTCGCG -> CAACTTCGCGT
GCAAGCCGTTG -> CAAGCCGTTGT
GCAAGCGCTAA -> CAAGCGCTAAA
GCAAGGGTATC -> CAAGGGTATCC
GCAAGTGCTAC -> CAAGTGCTACG
GCAATACCGGA -> CAATACCGGAT
GCAATAGGGCA -> CAATAGGGCAG
GCAATATCGAA -> CAATATCGAAC
GCACACTCGGA -> CACACTCGGAA
GCACATTTAAC -> CACATTTAACT
GCACCCACGAT -> CACCCACGATG
GCACCGCGGGA -> CACCGCGGGAG
GCAGAACTTCG -> CAGAACTTCGG
GCAGACAACTT -> CAGACAACTTC
GCAGATTTATC -> CAGATTTATCG
GCAGCCACCCA -> CAGCCACCCAA
GCAGCGACAGG -> CAGCGACAGGG
GCAGGATGAAA -> CAGGATGAAAG
GCAGGATTCCC -> CAGGATTCCCA
GCAGTAGTGTC -> CAGTAGTGTCG
GCAGTTAAGGG -> CAGTTAAGGGT
GCATAACAGGG -> CATAACAGGGA
GCATACTTCAG -> CATACTTCAGG
GCATGTCCTGC -> CATGTCCTGCC
GCATTACAGAC -> CATTACAGACG
GCATTCGCTAC -> CATTCGCTACA
GCATTTGTCTT -> CATTTGTCTTC
GCCACCCAAAG -> CCACCCAAAGA
GCCACCTAGAA -> CCACCTAGAAG
GCCACGTGGCC -> CCACGTGGCCT
GCCATAACACT -> CCATAACACTT
GCCATCCTCTT -> CCATCCTCTTA
GCCCACCTTCG -> CCCACCTTCGG
GCCCGCTGGCG -> CCCGCTGGCGA
GCCCGTGACTA -> CCCGTGACTAC
GCCCTTGTTTT -> CCCTTGTTTTA
GCCGAAAATAC -> CCGAAAATACC
GCCGACGCGGT -> CCGACGCGGTA
GCCGACGGTGT -> CCGACGGTGTA
GCCGCAAAATA -> CCGCAAAATAT
GCCGCTGCCTG -> CCGCTGCCTGT
GCCGGGCAATA -> CCGGGCAATAC
GCCGGGCTTGG -> CCGGGCTTGGG
GCCGTAGCACC -> CCGTAGCACCG
GCCGTTGTCAT -> CCGTTGTCATA
GCCTATCGCTC -> CCTATCGCTCC
GCCTCCAAGGC -> CCTCCAAGGCG
GCCTCTATCTG -> CCTCTATCTGT
GCCTGCCCACC -> CCTGCCCACCT
GCCTGTCGTGC -> CCTGTCGTGCT
GCCTGTGCGGT -> CCTGTGCGGTA
GCCTTACACCC -> CCTTACACCCA
GCCTTGAAGTC -> CCTTGAAGTCG
GCGAACGGCCT -> CGAACGGCCTA
GCGACAGGGGT -> CGACAGGGGTG
GCGACTGCCGC -> CGACTGCCGCA
GCGAGAGAGTA -> CGAGAGAGTAA
GCGCACACTCG -> CGCACACTCGG
GCGCAGCGACA -> CGCAGCGACAG
GCGCCCGTGAC -> CGCCCGTGACT
GCGCTAAATAT -> CGCTAAATATG
GCGGAGAGATT -> CGGAGAGATTG
GCGGATACGCT -> CGGATACGCTG
GCGGATATACT -> CGGATATACTC
GCGGCTCGAGG -> CGGCTCGAGGA
GCGGGAGCTGA -> CGGGAGCTGAG
GCGGGAGGCAT -> CGGGAGGCATG
GCGGGCCACGT -> CGGGCCACGTG
GCGGTACCCCG -> CGGTACCCCGT
GCGGTAGTCGA -> CGGTAGTCGAC
GCGGTCGCTCT -> CGGTCGCTCTT
GCGGTTGGGCC -> CGGTTGGGCCG
GCGTCACTCCT -> CGTCACTCCTC
GCGTCCGAATG -> CGTCCGAATGG
GCGTCGTCGCC -> CGTCGTCGCCA
GCGTCTCTATG -> CGTCTCTATGC
GCGTGAACGAT -> CGTGAACGATT
GCGTGACCGGA -> CGTGACCGGAG
GCGTGAGCGTC -> CGTGAGCGTCA
GCGTGAGTATA -> CGTGAGTATAA
GCGTGCTAAAT -> CGTGCTAAATC
GCGTGGAGAAA -> CGTGGAGAAAA
GCGTGGTGGCG -> CGTGGTGGCGT
GCGTTCTCGCT -> CGTTCTCGCTG
GCGTTTTGAGG -> CGTTTTGAGGG
GCTAAATATGA -> CTAAATATGAA
GCTAAATCCTC -> CTAAATCCTCC
GCTACAAATTA -> CTACAAATTAG
GCTACCATAAC -> CTACCATAACC
GCTACGCCGAC -> CTACGCCGACG
GCTACGGTATA -> CTACGGTATAG
GCTATAGTTCA -> CTATAGTTCAC
GCTCAAATAGT -> CTCAAATAGTC
GCTCAAATGGG -> CTCAAATGGGC
GCTCATGTTCA -> CTCATGTTCAT
GCTCCGCGGGA -> CTCCGCGGGAG
GCTCGAGGACT -> CTCGAGGACTG
GCTCGCTATAG -> CTCGCTATAGT
GCTCGTGTGTC -> CTCGTGTGTCT
GCTCTGTACCC -> CTCTGTACCCA
GCTCTTGTGTA -> CTCTTGTGTAT
GCTGACGTGAC -> CTGACGTGACC
GCTGAGCGTGA -> CTGAGCGTGAC
GCTGAGGGGAT -> CTGAGGGGATG
GCTGCCTGTCG -> CTGCCTGTCGT
GCTGGAAGTCT -> CTGGAAGTCTA
GCTGGACTGGC -> CTGGACTGGCG
GCTGGAGGTAG -> CTGGAGGTAGC
GCTGGCGACTG -> CTGGCGACTGC
GCTGGCTCTGT -> CTGGCTCTGTA
GCTGGGGCTGA -> CTGGGGCTGAC
GCTGTCCGCGT -> CTGTCCGCGTC
GCTGTTAACCG -> CTGTTAACCGT
GCTTCACGTAC -> CTTCACGTACG
GCTTCTTATTA -> CTTCTTATTAA
GCTTGGGGCGT -> CTTGGGGCGTC
GCTTGGGGTAT -> CTTGGGGTATG
GCTTTACGTAT -> CTTTACGTATG
GCTTTTCCCGC -> CTTTTCCCGCC
GCTTTTGTTTG -> CTTTTGTTTGG
GGAACGTATTG -> GAACGTATTGC
GGAACTCGCAT -> GAACTCGCATT
GGAAGTCTAAA -> GAAGTCTAAAG
GGAATCAGTAA -> GAATCAGTAAG
GGAATCCGAGA -> GAATCCGAGAA
GGACAACAAAA -> GACAACAAAAT
GGACTAGGAGC -> GACTAGGAGCA
GGACTGCTTTT -> GACTGCTTTTG
GGACTGGCGCA -> GACTGGCGCAG
GGACTGGCGTG -> GACTGGCGTGA
GGAGAAAACCG -> GAGAAAACCGC
GGAGAGATAGA -> GAGAGATAGAT
GGAGAGATTGT -> GAGAGATTGTC
GGAGCAATATC -> GAGCAATATCG
GGAGCTGAGGG -> GAGCTGAGGGG
GGAGGCATGTC -> GAGGCATGTCC
GGAGGTAGCAT -> GAGGTAGCATA
GGAGTCCACAG -> GAGTCCACAGT
GGAGTTAGAAC -> GAGTTAGAACT
GGAGTTGAGCA -> GAGTTGAGCAG
GGATACGCTGG -> GATACGCTGGG
GGATAGGGTAT -> GATAGGGTATA
GGATATACTCT -> GATATACTCTA
GGATCTTCGGG -> GATCTTCGGGT
GGATGAAAGTT -> GATGAAAGTTT
GGATGACTCAC -> GATGACTCACC
GGATGCAAGTG -> GATGCAAGTGC
GGATGCCCGCT -> GATGCCCGCTG
GGATGGGGTCC -> GATGGGGTCCA
GGATTCCCACC -> GATTCCCACCC
GGATTCGTATC -> GATTCGTATCC
GGATTGGCCTG -> GATTGGCCTGC
GGCAATACCGG -> GCAATACCGGA
GGCACCCACGA -> GCACCCACGAT
GGCAGCCACCC -> GCAGCCACCCA
GGCATAACAGG -> GCATAACAGGG
GGCATGTCCTG -> GCATGTCCTGC
GGCCACGTGGC -> GCCACGTGGCC
GGCCGACGGTG -> GCCGACGGTGT
GGCCGGGCTTG -> GCCGGGCTTGG
GGCCTATCGCT -> GCCTATCGCTC
GGCCTCCAAGG -> GCCTCCAAGGC
GGCCTGCCCAC -> GCCTGCCCACC
GGCCTTGAAGT -> GCCTTGAAGTC
GGCGAACGGCC -> GCGAACGGCCT
GGCGACTGCCG -> GCGACTGCCGC
GGCGAGAGAGT -> GCGAGAGAGTA
GGCGCACACTC -> GCGCACACTCG
GGCGCAGCGAC -> GCGCAGCGACA
GGCGCCCGTGA -> GCGCCCGTGAC
GGCGGTCGCTC -> GCGGTCGCTCT
GGCGTCGTCGC -> GCGTCGTCGCC
GGCGTGAGCGT -> GCGTGAGCGTC
GGCGTGAGTAT -> GCGTGAGTATA
GGCGTGGTGGC -> GCGTGGTGGCG
GGCTACCATAA -> GCTACCATAAC
GGCTACGCCGA -> GCTACGCCGAC
GGCTCGAGGAC -> GCTCGAGGACT
GGCTCTGTACC -> GCTCTGTACCC
GGCTGACGTGA -> GCTGACGTGAC
GGCTTCACGTA -> GCTTCACGTAC
GGCTTGGGGTA -> GCTTGGGGTAT
GGCTTTTCCCG -> GCTTTTCCCGC
GGGAACTCGCA -> GGAACTCGCAT
GGGAATCAGTA -> GGAATCAGTAA
GGGAGCTGAGG -> GGAGCTGAGGG
GGGAGGCATGT -> GGAGGCATGTC
GGGAGTTAGAA -> GGAGTTAGAAC
GGGATCTTCGG -> GGATCTTCGGG
GGGATGACTCA -> GGATGACTCAC
GGGATGGGGTC -> GGATGGGGTCC
GGGATTGGCCT -> GGATTGGCCTG
GGGCAATACCG -> GGCAATACCGG
GGGCACCCACG -> GGCACCCACGA
GGGCAGCCACC -> GGCAGCCACCC
GGGCCACGTGG -> GGCCACGTGGC
GGGCCGGGCTT -> GGCCGGGCTTG
GGGCCTCCAAG -> GGCCTCCAAGG
GGGCGAACGGC -> GGCGAACGGCC
GGGCGTCGTCG -> GGCGTCGTCGC
GGGCTACCATA -> GGCTACCATAA
GGGCTGACGTG -> GGCTGACGTGA
GGGCTTGGGGT -> GGCTTGGGGTA
GGGCTTTTCCC -> GGCTTTTCCCG
GGGGAATCAGT -> GGGAATCAGTA
GGGGATGGGGT -> GGGATGGGGTC
GGGGCACCCAC -> GGGCACCCACG
GGGGCGTCGTC -> GGGCGTCGTCG
GGGGCTGACGT -> GGGCTGACGTG
GGGGTATGCCG -> GGGTATGCCGT
GGGGTCCAGTC -> GGGTCCAGTCG
GGGGTGGTCGT -> GGGTGGTCGTT
GGGTACATAGA -> GGTACATAGAA
GGGTATAATGA -> GGTATAATGAC
GGGTATCCACC -> GGTATCCACCA
GGGTATGCCGT -> GGTATGCCGTA
GGGTCCAGTCG -> GGTCCAGTCGT
GGGTCCCGCTC -> GGTCCCGCTCA
GGGTCGACAAA -> GGTCGACAAAT
GGGTCTTTTCT -> GGTCTTTTCTC
GGGTGGTCGTT -> GGTGGTCGTTG
GGTACATAGAA -> GTACATAGAAA
GGTACCCCGTC -> GTACCCCGTCA
GGTAGCAACCC -> GTAGCAACCCA
GGTAGCATACT -> GTAGCATACTT
GGTAGTCGACA -> GTAGTCGACAA
GGTATAAGGTC -> GTATAAGGTCG
GGTATAATGAC -> GTATAATGACA
GGTATAGTGCT -> GTATAGTGCTT
GGTATCCACCA -> GTATCCACCAT
GGTATGCCGTA -> GTATGCCGTAG
GGTCATTTTCT -> GTCATTTTCTC
GGTCCAGTCGT -> GTCCAGTCGTC
GGTCCCGCTCA -> GTCCCGCTCAT
GGTCCGGTAGC -> GTCCGGTAGCA
GGTCGACAAAT -> GTCGACAAATA
GGTCGACAATA -> GTCGACAATAA
GGTCGAGCTGT -> GTCGAGCTGTT
GGTCGCTCTTG -> GTCGCTCTTGT
GGTCGTTGAAA -> GTCGTTGAAAC
GGTCTCAGACT -> GTCTCAGACTG
GGTCTTTTCTC -> GTCTTTTCTCC
GGTGGCGTGAG -> GTGGCGTGAGT
GGTGGTCGTTG -> GTGGTCGTTGA
GGTGTATGGGT -> GTGTATGGGTC
GGTTAAGTCGA -> GTTAAGTCGAA
GGTTATTGATA -> GTTATTGATAG
GGTTCCTAGGA -> GTTCCTAGGAA
GGTTGGGCCGG -> GTTGGGCCGGG
GGTTTGGGATG -> GTTTGGGATGA
GTAAAGCGGTT -> TAAAGCGGTTG
GTAACGGAGGT -> TAACGGAGGTT
GTAACTGTATT -> TAACTGTATTC
GTAAGCAGGAT -> TAAGCAGGATG
GTACACTAACA -> TACACTAACAG
GTACATAGAAA -> TACATAGAAAG
GTACCCAGCCG -> TACCCAGCCGA
GTACCCCGTCA -> TACCCCGTCAG
GTACGACGACT -> TACGACGACTA
GTACGTCGCGT -> TACGTCGCGTT
GTACTCGTGGC -> TACTCGTGGCT
GTACTTATGGG -> TACTTATGGGG
GTAGCAACCCA -> TAGCAACCCAT
GTAGCACCGCG -> TAGCACCGCGG
GTAGCATACTT -> TAGCATACTTC
GTAGTACACTA -> TAGTACACTAA
GTAGTCGACAA -> TAGTCGACAAA
GTAGTGTCGGA -> TAGTGTCGGAT
GTATAAACTTA -> TATAAACTTAA
GTATAAGGTCG -> TATAAGGTCGA
GTATAATGACA -> TATAATGACAT
GTATAGTGCTT -> TATAGTGCTTC
GTATCCACCAT -> TATCCACCATC
GTATCCTTATC -> TATCCTTATCG
GTATGCAGGAT -> TATGCAGGATT
GTATGCCGTAG -> TATGCCGTAGC
GTATGGGTCTT -> TATGGGTCTTT
GTATGTCCAAG -> TATGTCCAAGG
GTATGTTCCCA -> TATGTTCCCAT
GTATTCCAAAA -> TATTCCAAAAC
GTATTGCAGAA -> TATTGCAGAAC
GTCACGCTTGG -> TCACGCTTGGG
GTCACTCCTCT -> TCACTCCTCTA
GTCAGCAAGCG -> TCAGCAAGCGC
GTCAGTTGGTC -> TCAGTTGGTCT
GTCATAATAGA -> TCATAATAGAA
GTCATTATCTG -> TCATTATCTGG
GTCATTTTCTC -> TCATTTTCTCA
GTCCAAGGGAA -> TCCAAGGGAAC
GTCCACAGTTC -> TCCACAGTTCA,TCCACAGTTCT
GTCCAGTCGTC -> TCCAGTCGTCC
GTCCCGAAGCT -> TCCCGAAGCTG
GTCCCGCTCAT -> TCCCGCTCATG
GTCCGAATGGA -> TCCGAATGGAC
GTCCGCGTCTC -> TCCGCGTCTCT
GTCCGGTAGCA -> TCCGGTAGCAA
GTCCGTAACGG -> TCCGTAACGGA
GTCCTAAAACT -> TCCTAAAACTT
GTCCTGCCCTT -> TCCTGCCCTTG
GTCGAATCGTG -> TCGAATCGTGC
GTCGACAAACT -> TCGACAAACTG
GTCGACAAATA -> TCGACAAATAG
GTCGACAATAA -> TCGACAATAAA
GTCGAGCTGTT -> TCGAGCTGTTA
GTCGCCATAAC -> TCGCCATAACA
GTCGCGGATAT -> TCGCGGATATA
GTCGCGTTCTC -> TCGCGTTCTCG
GTCGCTCTTGT -> TCGCTCTTGTG
GTCGGATGCAA -> TCGGATGCAAG
GTCGTACTTAT -> TCGTACTTATG
GTCGTCCACAG -> TCGTCCACAGT
GTCGTCGCCAT -> TCGTCGCCATA
GTCGTGCAAGG -> TCGTGCAAGGG
GTCGTGCTCAA -> TCGTGCTCAAA
GTCGTGGTATA -> TCGTGGTATAA
GTCGTTGAAAC -> TCGTTGAAACA
GTCTAAAGGTT -> TCTAAAGGTTA
GTCTAATTGTC -> TCTAATTGTCA
GTCTCAGACTG -> TCTCAGACTGT
GTCTCTATGCG -> TCTCTATGCGT
GTCTCTGAGAA -> TCTCTGAGAAA
GTCTTCCTTAC -> TCTTCCTTACG
GTCTTTTCTCC -> TCTTTTCTCCG
GTGAACGATTT -> TGAACGATTTA
GTGACCGGAGA -> TGACCGGAGAG
GTGACCTTGTA -> TGACCTTGTAC
GTGACTACTCT -> TGACTACTCTT
GTGAGCGTCAC -> TGAGCGTCACT
GTGAGTATAAA -> TGAGTATAAAC
GTGCAAGGGTA -> TGCAAGGGTAT
GTGCAATAGGG -> TGCAATAGGGC
GTGCCTCTATC -> TGCCTCTATCT
GTGCGGCTCGA -> TGCGGCTCGAG
GTGCGGTACCC -> TGCGGTACCCC
GTGCGTGCTAA -> TGCGTGCTAAA
GTGCTAAATCC -> TGCTAAATCCT
GTGCTACGGTA -> TGCTACGGTAT
GTGCTCAAATA -> TGCTCAAATAG
GTGCTCAAATG -> TGCTCAAATGG
GTGCTTCTTAT -> TGCTTCTTATT
GTGGAGAAAAC -> TGGAGAAAACC
GTGGCATAACA -> TGGCATAACAG
GTGGCCTTGAA -> TGGCCTTGAAG
GTGGCGTGAGT -> TGGCGTGAGTA
GTGGCGTGGTG -> TGGCGTGGTGG
GTGGCTACGCC -> TGGCTACGCCG
GTGGTATAAGG -> TGGTATAAGGT
GTGGTCGTTGA -> TGGTCGTTGAA
GTGGTGGCGTG -> TGGTGGCGTGA
GTGGTTTGGGA -> TGGTTTGGGAT
GTGTATGCAGG -> TGTATGCAGGA
GTGTATGGGTC -> TGTATGGGTCT
GTGTCCTAAAA -> TGTCCTAAAAC
GTGTCGGATGC -> TGTCGGATGCA
GTGTCTAATTG -> TGTCTAATTGT
GTGTGTCTAAT -> TGTGTCTAATT
GTGTTAACGCA -> TGTTAACGCAA
GTTAACCGTTG -> TTAACCGTTGT
GTTAACGCAAG -> TTAACGCAAGC
GTTAAGGGTAC -> TTAAGGGTACA
GTTAAGTCGAA -> TTAAGTCGAAT
GTTACCCTGCT -> TTACCCTGCTG
GTTAGAACTTT -> TTAGAACTTTA
GTTAGGAGTCC -> TTAGGAGTCCA
GTTATTGATAG -> TTATTGATAGC
GTTATTTACGA -> TTATTTACGAT
GTTCACAGTAC -> TTCACAGTACT
GTTCATAGTGG -> TTCATAGTGGC
GTTCATCAGAC -> TTCATCAGACG
GTTCATCGACT -> TTCATCGACTC
GTTCATGTGTT -> TTCATGTGTTA
GTTCCATTTCG -> TTCCATTTCGC
GTTCCCATTGC -> TTCCCATTGCG
GTTCCTAGGAA -> TTCCTAGGAAT
GTTCTAGCCTT -> TTCTAGCCTTA
GTTCTCGCTGG -> TTCTCGCTGGC
GTTGAAACACA -> TTGAAACACAT
GTTGAGCAGTA -> TTGAGCAGTAG
GTTGGCGCCCG -> TTGGCGCCCGT
GTTGGGCCGGG -> TTGGGCCGGGC
GTTGGTCTCAG -> TTGGTCTCAGA
GTTGTCATAAT -> TTGTCATAATA
GTTGTCGCGGA -> TTGTCGCGGAT
GTTTAACCGCC -> TTTAACCGCCT
GTTTCCTTAAA -> TTTCCTTAAAC
GTTTGGGAGTT -> TTTGGGAGTTA
GTTTGGGATGA -> TTTGGGATGAC
GTTTTATAATC -> TTTTATAATCA
GTTTTGAGGGG -> TTTTGAGGGGA
GTTTTTCGAAA -> TTTTTCGAAAA
TAAAACTTCAT -> AAAACTTCATA
TAAACAGCTCG -> AAACAGCTCGC
TAAACTTAACG -> AAACTTAACGA
TAAAGCGGTTG -> AAAGCGGTTGG
TAAAGGTTAAG -> AAAGGTTAAGT
TAAATAACAAT -> AAATAACAATA
TAAATATGAAG -> AAATATGAAGT
TAAATCCTCCG -> AAATCCTCCGT
TAACAATACCT -> AACAATACCTG
TAACACTTGAA -> AACACTTGAAA
TAACAGCAGAT -> AACAGCAGATT
TAACAGGGATT -> AACAGGGATTG
TAACAGTGGTT -> AACAGTGGTTT
TAACCCTCACC -> AACCCTCACCT
TAACCCTTTAT -> AACCCTTTATG
TAACCGCCTGT -> AACCGCCTGTG
TAACCGTTGTC -> AACCGTTGTCG
TAACGATTAAT -> AACGATTAATA
TAACGCAAGCC -> AACGCAAGCCG
TAACGGACTAG -> AACGGACTAGG
TAACGGAGGTT -> AACGGAGGTTC
TAACGGGTCGA -> AACGGGTCGAC
TAACTCATCCA -> AACTCATCCAG
TAACTGTATTC -> AACTGTATTCC
TAAGCAGGATG -> AAGCAGGATGA
TAAGGGTACAT -> AAGGGTACATA
TAAGGTCGACA -> AAGGTCGACAA
TAAGTATGTCC -> AAGTATGTCCA
TAAGTCGAATC -> AAGTCGAATCG
TAATACATGAG -> AATACATGAGG
TAATAGAAATT -> AATAGAAATTC
TAATCAGCTTT -> AATCAGCTTTA
TAATGACATCA -> AATGACATCAG
TAATTAGCATT -> AATTAGCATTA
TAATTGTCATT -> AATTGTCATTA
TACAAATTAGA -> ACAAATTAGAG
TACACCCAAAT -> ACACCCAAATC
TACACTAACAG -> ACACTAACAGC
TACAGACGTGG -> ACAGACGTGGC
TACATAGAAAG -> ACATAGAAAGG
TACATGAGGGC -> ACATGAGGGCT
TACCATAACCC -> ACCATAACCCT
TACCCAGCCGA -> ACCCAGCCGAA
TACCCCGTCAG -> ACCCCGTCAGT
TACCCTGCTGG -> ACCCTGCTGGA
TACCGGATGCC -> ACCGGATGCCC
TACCGGGCTAC -> ACCGGGCTACC
TACCGTTAGGA -> ACCGTTAGGAG
TACCTGAGCGG -> ACCTGAGCGGG
TACGACGACTA -> ACGACGACTAC
TACGACTCGAA -> ACGACTCGAAG
TACGATGATCT -> ACGATGATCTA
TACGCCGACGC -> ACGCCGACGCG
TACGCTGGGGC -> ACGCTGGGGCT
TACGGTATAGT -> ACGGTATAGTG
TACGTATGTTC -> ACGTATGTTCC
TACGTCGCGTT -> ACGTCGCGTTC
TACTCGTGGCT -> ACTCGTGGCTA
TACTCTAACGG -> ACTCTAACGGA
TACTCTTTTTT -> ACTCTTTTTTG
TACTTATGGGG -> ACTTATGGGGC
TACTTCAGGTT -> ACTTCAGGTTC
TACTTTCAGAC -> ACTTTCAGACC
TAGAAAGGGAT -> AGAAAGGGATC
TAGAAATGTTG -> AGAAATGTTGG
TAGAAATTCGT -> AGAAATTCGTG
TAGAACTTTAG -> AGAACTTTAGT
TAGAAGACTTG -> AGAAGACTTGT
TAGAGCCACCT -> AGAGCCACCTA
TAGATAACCCT -> AGATAACCCTT
TAGCAACAGTT -> AGCAACAGTTT
TAGCAACCCAT -> AGCAACCCATC
TAGCACCGCGG -> AGCACCGCGGG
TAGCATACTTC -> AGCATACTTCA
TAGCATTACAG -> AGCATTACAGA
TAGCCTTACAC -> AGCCTTACACC
TAGCGGAGAGA -> AGCGGAGAGAT
TAGGAATCCGA -> AGGAATCCGAG
TAGGAGCAATA -> AGGAGCAATAT
TAGGAGTCCAC -> AGGAGTCCACA
TAGGAGTTGAG -> AGGAGTTGAGC
TAGGATTCGTA -> AGGATTCGTAT
TAGGCGGTCGC -> AGGCGGTCGCT
TAGGGCAGCCA -> AGGGCAGCCAC
TAGGGTATAAT -> AGGGTATAATG
TAGGTCATTTT -> AGGTCATTTTC
TAGTACACTAA -> AGTACACTAAC
TAGTCGACAAA -> AGTCGACAAAC
TAGTCGTACTT -> AGTCGTACTTA
TAGTCGTGGTA -> AGTCGTGGTAT
TAGTGCTTCTT -> AGTGCTTCTTA
TAGTGGCGTGG -> AGTGGCGTGGT
TAGTGTCGGAT -> AGTGTCGGATG
TAGTTCACAGT -> AGTTCACAGTA
TATAAACTTAA -> ATAAACTTAAC
TATAAGGTCGA -> ATAAGGTCGAC
TATAATCAGCT -> ATAATCAGCTT
TATAATGACAT -> ATAATGACATC
TATACTCTAAC -> ATACTCTAACG
TATAGTGCTTC -> ATAGTGCTTCT
TATAGTTCACA -> ATAGTTCACAG
TATCCACCATC -> ATCCACCATCA
TATCCTTATCG -> ATCCTTATCGC
TATCGAACTAC -> ATCGAACTACT
TATCGCGTGGA -> ATCGCGTGGAG
TATCGCTCCGC -> ATCGCTCCGCG
TATCGCTGGAA -> ATCGCTGGAAG
TATCTGGTTAT -> ATCTGGTTATT
TATCTGTCCCG -> ATCTGTCCCGA
TATGAAGTGCG -> ATGAAGTGCGT
TATGAAGTTCA -> ATGAAGTTCAT
TATGCAGGATT -> ATGCAGGATTC
TATGCATTCGC -> ATGCATTCGCT
TATGCCGTAGC -> ATGCCGTAGCA
TATGCGTCCGA -> ATGCGTCCGAA
TATGGGGCACC -> ATGGGGCACCC
TATGGGTCTTT -> ATGGGTCTTTT
TATGTCCAAGG -> ATGTCCAAGGG
TATGTTCCCAT -> ATGTTCCCATT
TATTAACGGGT -> ATTAACGGGTC
TATTCCAAAAC -> ATTCCAAAACG
TATTCGTAGTA -> ATTCGTAGTAC
TATTGATAGCA -> ATTGATAGCAA
TATTGCAGAAC -> ATTGCAGAACT
TATTTACGATG -> ATTTACGATGA
TCAAATAGTCG -> CAAATAGTCGT
TCAAATGGGCC -> CAAATGGGCCT
TCAACAAAGGG -> CAACAAAGGGC
TCAACGGATAG -> CAACGGATAGG
TCAAGTGCTCA -> CAAGTGCTCAA
TCACAGTACTC -> CACAGTACTCG
TCACCCGCAGT -> CACCCGCAGTT
TCACCTTCGAT -> CACCTTCGATA
TCACGCTTGGG -> CACGCTTGGGG
TCACGTACGAC -> CACGTACGACG
TCACTCCTCTA -> CACTCCTCTAA
TCAGACCCCAC -> CAGACCCCACG
TCAGACGCACA -> CAGACGCACAT
TCAGACTGTTA -> CAGACTGTTAC
TCAGCAAGCGC -> CAGCAAGCGCT
TCAGCCGCTGC -> CAGCCGCTGCC
TCAGCTTTACG -> CAGCTTTACGT
TCAGGTTCCTA -> CAGGTTCCTAG
TCAGTAAAGCG -> CAGTAAAGCGG
TCAGTAAGCAG -> CAGTAAGCAGG
TCAGTTCATGT -> CAGTTCATGTG
TCAGTTGGTCT -> CAGTTGGTCTC
TCATAACAGTG -> CATAACAGTGG
TCATAATAGAA -> CATAATAGAAA
TCATAGTGGCG -> CATAGTGGCGT
TCATATGCATT -> CATATGCATTC
TCATCAGACGC -> CATCAGACGCA
TCATCCAGACA -> CATCCAGACAG
TCATCGACTCG -> CATCGACTCGC
TCATGTGTTAA -> CATGTGTTAAC
TCATGTTCATA -> CATGTTCATAG
TCATTATCTGG -> CATTATCTGGT
TCATTTTCTCA -> CATTTTCTCAG
TCCAAAACGCT -> CCAAAACGCTC
TCCAAGGCGCA -> CCAAGGCGCAC
TCCAAGGGAAC -> CCAAGGGAACT
TCCACAGTTCA -> CCACAGTTCAT
TCCACAGTTCT -> CCACAGTTCTA
TCCACCATCAA -> CCACCATCAAC
TCCAGACAGGT -> CCAGACAGGTC
TCCAGTCGTCC -> CCAGTCGTCCA
TCCATTTCGCG -> CCATTTCGCGG
TCCCACCCGTG -> CCCACCCGTGT
TCCCATTGCGT -> CCCATTGCGTT
TCCCGAAGCTG -> CCCGAAGCTGG
TCCCGCCGGGC -> CCCGCCGGGCA
TCCCGCTCATG -> CCCGCTCATGT
TCCGAATGGAC -> CCGAATGGACA
TCCGAGAAAAA -> CCGAGAAAAAT
TCCGATAGGTC -> CCGATAGGTCA
TCCGCGGGAGC -> CCGCGGGAGCT
TCCGCGTCTCT -> CCGCGTCTCTA
TCCGGTAGCAA -> CCGGTAGCAAC
TCCGTAACGGA -> CCGTAACGGAG
TCCGTTTCCTT -> CCGTTTCCTTA
TCCTAAAACTT -> CCTAAAACTTC
TCCTAGGAATC -> CCTAGGAATCC
TCCTCCGTTTC -> CCTCCGTTTCC
TCCTCTAAGTA -> CCTCTAAGTAT
TCCTCTTAATT -> CCTCTTAATTA
TCCTGCCCTTG -> CCTGCCCTTGT
TCCTTAAACAG -> CCTTAAACAGC
TCCTTACGACT -> CCTTACGACTC
TCCTTATCGCG -> CCTTATCGCGT
TCGAAAACACT -> CGAAAACACTT
TCGAACTACTT -> CGAACTACTTT
TCGAAGCAACT -> CGAAGCAACTT
TCGAATCGTGC -> CGAATCGTGCG
TCGACAAACTG -> CGACAAACTGC
TCGACAAATAG -> CGACAAATAGG
TCGACAATAAA -> CGACAATAAAT
TCGACTCGCCA -> CGACTCGCCAT
TCGAGCTGTTA -> CGAGCTGTTAA
TCGAGGACTGG -> CGAGGACTGGC
TCGATAGGCGG -> CGATAGGCGGT
TCGCATTTGTC -> CGCATTTGTCT
TCGCCATAACA -> CGCCATAACAC
TCGCCATCCTC -> CGCCATCCTCT
TCGCGGATACG -> CGCGGATACGC
TCGCGGATATA -> CGCGGATATAC
TCGCGTGAACG -> CGCGTGAACGA
TCGCGTGGAGA -> CGCGTGGAGAA
TCGCGTTCTCG -> CGCGTTCTCGC
TCGCTACAAAT -> CGCTACAAATT
TCGCTATAGTT -> CGCTATAGTTC
TCGCTCCGCGG -> CGCTCCGCGGG
TCGCTCTTGTG -> CGCTCTTGTGT
TCGCTGGAAGT -> CGCTGGAAGTC
TCGCTGGCTCT -> CGCTGGCTCTG
TCGGAACGTAT -> CGGAACGTATT
TCGGATGCAAG -> CGGATGCAAGT
TCGGCGAGAGA -> CGGCGAGAGAG
TCGGCTTCACG -> CGGCTTCACGT
TCGGGTCCCGC -> CGGGTCCCGCT
TCGGTCGAGCT -> CGGTCGAGCTG
TCGTACTTATG -> CGTACTTATGG
TCGTAGTACAC -> CGTAGTACACT
TCGTATCCTTA -> CGTATCCTTAT
TCGTCCACAGT -> CGTCCACAGTT
TCGTCGCCATA -> CGTCGCCATAA
TCGTCTCTGAG -> CGTCTCTGAGA
TCGTGCAAGGG -> CGTGCAAGGGT
TCGTGCCTCTA -> CGTGCCTCTAT
TCGTGCGGCTC -> CGTGCGGCTCG
TCGTGCTCAAA -> CGTGCTCAAAT
TCGTGGCTACG -> CGTGGCTACGC
TCGTGGTATAA -> CGTGGTATAAG
TCGTGTGTCTA -> CGTGTGTCTAA
TCGTTGAAACA -> CGTTGAAACAC
TCTAAAGGTTA -> CTAAAGGTTAA
TCTAACGGACT -> CTAACGGACTA
TCTAAGTATGT -> CTAAGTATGTC
TCTAATTGTCA -> CTAATTGTCAT
TCTAGCCTTAC -> CTAGCCTTACA
TCTAGCGGAGA -> CTAGCGGAGAG
TCTATCTGTCC -> CTATCTGTCCC
TCTATGCGTCC -> CTATGCGTCCG
TCTCAGACTGT -> CTCAGACTGTT
TCTCAGTTCAT -> CTCAGTTCATG
TCTCCGATAGG -> CTCCGATAGGT
TCTCGCTGGCT -> CTCGCTGGCTC
TCTCTATGCGT -> CTCTATGCGTC
TCTCTGAGAAA -> CTCTGAGAAAA
TCTGAGAAAAT -> CTGAGAAAATT
TCTGGTTATTG -> CTGGTTATTGA
TCTGTACCCAG -> CTGTACCCAGC
TCTGTCCCGAA -> CTGTCCCGAAG
TCTTAATTAGC -> CTTAATTAGCA
TCTTATTAACG -> CTTATTAACGG
TCTTCCTTACG -> CTTCCTTACGA
TCTTCGGGTCC -> CTTCGGGTCCC
TCTTGTGTATG -> CTTGTGTATGC
TCTTTTCTCCG -> CTTTTCTCCGA
TCTTTTTTGTG -> CTTTTTTGTGC
TGAAAAGGCCG -> GAAAAGGCCGA
TGAAACACATC -> GAAACACATCA
TGAAAGTTTAA -> GAAAGTTTAAC
TGAACGATTTA -> GAACGATTTAG
TGAAGTCGTGC -> GAAGTCGTGCA
TGAAGTGCGTG -> GAAGTGCGTGC
TGAAGTTCATC -> GAAGTTCATCG
TGACATCAGTA -> GACATCAGTAA
TGACCGGAGAG -> GACCGGAGAGA
TGACCTTGTAC -> GACCTTGTACG
TGACGTGACCT -> GACGTGACCTT
TGACTACTCTT -> GACTACTCTTT
TGACTCACCCG -> GACTCACCCGC
TGAGAAAATTG -> GAGAAAATTGC
TGAGCAGTAGT -> GAGCAGTAGTG
TGAGCGGGCCA -> GAGCGGGCCAC
TGAGCGTCACT -> GAGCGTCACTC
TGAGCGTGACC -> GAGCGTGACCG
TGAGGGCTTTT -> GAGGGCTTTTC
TGAGGGGAATC -> GAGGGGAATCA
TGAGGGGATGG -> GAGGGGATGGG
TGAGTATAAAC -> GAGTATAAACT
TGATAGCAACA -> GATAGCAACAG
TGATCTAGCGG -> GATCTAGCGGA
TGCAAGGGTAT -> GCAAGGGTATC
TGCAAGTGCTA -> GCAAGTGCTAC
TGCAATAGGGC -> GCAATAGGGCA
TGCAGAACTTC -> GCAGAACTTCG
TGCAGACAACT -> GCAGACAACTT
TGCAGGATTCC -> GCAGGATTCCC
TGCATTCGCTA -> GCATTCGCTAC
TGCCCACCTTC -> GCCCACCTTCG
TGCCCGCTGGC -> GCCCGCTGGCG
TGCCCTTGTTT -> GCCCTTGTTTT
TGCCGCAAAAT -> GCCGCAAAATA
TGCCGTAGCAC -> GCCGTAGCACC
TGCCTCTATCT -> GCCTCTATCTG
TGCCTGTCGTG -> GCCTGTCGTGC
TGCGGCTCGAG -> GCGGCTCGAGG
TGCGGTACCCC -> GCGGTACCCCG
TGCGTCCGAAT -> GCGTCCGAATG
TGCGTGCTAAA -> GCGTGCTAAAT
TGCGTTTTGAG -> GCGTTTTGAGG
TGCTAAATCCT -> GCTAAATCCTC
TGCTACGGTAT -> GCTACGGTATA
TGCTCAAATAG -> GCTCAAATAGT
TGCTCAAATGG -> GCTCAAATGGG
TGCTGAGCGTG -> GCTGAGCGTGA
TGCTGGAGGTA -> GCTGGAGGTAG
TGCTTCTTATT -> GCTTCTTATTA
TGCTTTTGTTT -> GCTTTTGTTTG
TGGAAGTCTAA -> GGAAGTCTAAA
TGGACAACAAA -> GGACAACAAAA
TGGACTGCTTT -> GGACTGCTTTT
TGGACTGGCGC -> GGACTGGCGCA
TGGAGAAAACC -> GGAGAAAACCG
TGGAGGTAGCA -> GGAGGTAGCAT
TGGCATAACAG -> GGCATAACAGG
TGGCCTGCCCA -> GGCCTGCCCAC
TGGCCTTGAAG -> GGCCTTGAAGT
TGGCGACTGCC -> GGCGACTGCCG
TGGCGCAGCGA -> GGCGCAGCGAC
TGGCGCCCGTG -> GGCGCCCGTGA
TGGCGTGAGCG -> GGCGTGAGCGT
TGGCGTGAGTA -> GGCGTGAGTAT
TGGCGTGGTGG -> GGCGTGGTGGC
TGGCTACGCCG -> GGCTACGCCGA
TGGCTCTGTAC -> GGCTCTGTACC
TGGGAGTTAGA -> GGGAGTTAGAA
TGGGATGACTC -> GGGATGACTCA
TGGGCCGGGCT -> GGGCCGGGCTT
TGGGCCTCCAA -> GGGCCTCCAAG
TGGGGCACCCA -> GGGGCACCCAC
TGGGGCGTCGT -> GGGGCGTCGTC
TGGGGCTGACG -> GGGGCTGACGT
TGGGGTATGCC -> GGGGTATGCCG
TGGGGTCCAGT -> GGGGTCCAGTC
TGGGTCTTTTC -> GGGTCTTTTCT
TGGTATAAGGT -> GGTATAAGGTC
TGGTCGTTGAA -> GGTCGTTGAAA
TGGTCTCAGAC -> GGTCTCAGACT
TGGTGGCGTGA -> GGTGGCGTGAG
TGGTTATTGAT -> GGTTATTGATA
TGGTTTGGGAT -> GGTTTGGGATG
TGTACCCAGCC -> GTACCCAGCCG
TGTACGTCGCG -> GTACGTCGCGT
TGTATGCAGGA -> GTATGCAGGAT
TGTATGGGTCT -> GTATGGGTCTT
TGTATTCCAAA -> GTATTCCAAAA
TGTCACGCTTG -> GTCACGCTTGG
TGTCAGCAAGC -> GTCAGCAAGCG
TGTCATAATAG -> GTCATAATAGA
TGTCATTATCT -> GTCATTATCTG
TGTCCAAGGGA -> GTCCAAGGGAA
TGTCCCGAAGC -> GTCCCGAAGCT
TGTCCGCGTCT -> GTCCGCGTCTC
TGTCCGTAACG -> GTCCGTAACGG
TGTCCTAAAAC -> GTCCTAAAACT
TGTCCTGCCCT -> GTCCTGCCCTT
TGTCGCGGATA -> GTCGCGGATAT
TGTCGGATGCA -> GTCGGATGCAA
TGTCGTGCTCA -> GTCGTGCTCAA
TGTCTAATTGT -> GTCTAATTGTC
TGTCTTCCTTA -> GTCTTCCTTAC
TGTGCAATAGG -> GTGCAATAGGG
TGTGCGGTACC -> GTGCGGTACCC
TGTGTATGCAG -> GTGTATGCAGG
TGTGTCTAATT -> GTGTCTAATTG
TGTGTTAACGC -> GTGTTAACGCA
TGTTAACCGTT -> GTTAACCGTTG
TGTTAACGCAA -> GTTAACGCAAG
TGTTACCCTGC -> GTTACCCTGCT
TGTTCATAGTG -> GTTCATAGTGG
TGTTCCCATTG -> GTTCCCATTGC
TGTTGGCGCCC -> GTTGGCGCCCG
TGTTTGGGAGT -> GTTTGGGAGTT
TGTTTTATAAT -> GTTTTATAATC
TTAAACAGCTC -> TAAACAGCTCG
TTAACCGCCTG -> TAACCGCCTGT
TTAACCGTTGT -> TAACCGTTGTC
TTAACGATTAA -> TAACGATTAAT
TTAACGCAAGC -> TAACGCAAGCC
TTAACGGGTCG -> TAACGGGTCGA
TTAACTCATCC -> TAACTCATCCA
TTAAGGGTACA -> TAAGGGTACAT
TTAAGTCGAAT -> TAAGTCGAATC
TTAATACATGA -> TAATACATGAG
TTAATTAGCAT -> TAATTAGCATT
TTACACCCAAA -> TACACCCAAAT
TTACAGACGTG -> TACAGACGTGG
TTACCCTGCTG -> TACCCTGCTGG
TTACGACTCGA -> TACGACTCGAA
TTACGATGATC -> TACGATGATCT
TTACGTATGTT -> TACGTATGTTC
TTAGAAATGTT -> TAGAAATGTTG
TTAGAACTTTA -> TAGAACTTTAG
TTAGAGCCACC -> TAGAGCCACCT
TTAGCATTACA -> TAGCATTACAG
TTAGGAGTCCA -> TAGGAGTCCAC
TTAGGAGTTGA -> TAGGAGTTGAG
TTAGTCGTGGT -> TAGTCGTGGTA
TTATAATCAGC -> TATAATCAGCT
TTATCGCGTGG -> TATCGCGTGGA
TTATCGCTGGA -> TATCGCTGGAA
TTATCTGGTTA -> TATCTGGTTAT
TTATGAAGTTC -> TATGAAGTTCA
TTATGGGGCAC -> TATGGGGCACC
TTATTAACGGG -> TATTAACGGGT
TTATTGATAGC -> TATTGATAGCA
TTATTTACGAT -> TATTTACGATG
TTCACAGTACT -> TCACAGTACTC
TTCACGTACGA -> TCACGTACGAC
TTCAGACCCCA -> TCAGACCCCAC
TTCAGCCGCTG -> TCAGCCGCTGC
TTCAGGTTCCT -> TCAGGTTCCTA
TTCATAACAGT -> TCATAACAGTG
TTCATAGTGGC -> TCATAGTGGCG
TTCATCAGACG -> TCATCAGACGC
TTCATCGACTC -> TCATCGACTCG
TTCATGTGTTA -> TCATGTGTTAA
TTCCAAAACGC -> TCCAAAACGCT
TTCCATTTCGC -> TCCATTTCGCG
TTCCCACCCGT -> TCCCACCCGTG
TTCCCATTGCG -> TCCCATTGCGT
TTCCCGCCGGG -> TCCCGCCGGGC
TTCCTAGGAAT -> TCCTAGGAATC
TTCCTTAAACA -> TCCTTAAACAG
TTCCTTACGAC -> TCCTTACGACT
TTCGAAAACAC -> TCGAAAACACT
TTCGATAGGCG -> TCGATAGGCGG
TTCGCGGATAC -> TCGCGGATACG
TTCGCGTGAAC -> TCGCGTGAACG
TTCGCTACAAA -> TCGCTACAAAT
TTCGGCGAGAG -> TCGGCGAGAGA
TTCGGGTCCCG -> TCGGGTCCCGC
TTCGGTCGAGC -> TCGGTCGAGCT
TTCGTAGTACA -> TCGTAGTACAC
TTCGTATCCTT -> TCGTATCCTTA
TTCGTGCCTCT -> TCGTGCCTCTA
TTCTAGCCTTA -> TCTAGCCTTAC
TTCTCAGTTCA -> TCTCAGTTCAT
TTCTCCGATAG -> TCTCCGATAGG
TTCTCGCTGGC -> TCTCGCTGGCT
TTCTTATTAAC -> TCTTATTAACG
TTGAAAAGGCC -> TGAAAAGGCCG
TTGAAACACAT -> TGAAACACATC
TTGAAGTCGTG -> TGAAGTCGTGC
TTGAGCAGTAG -> TGAGCAGTAGT
TTGAGGGGAAT -> TGAGGGGAATC
TTGATAGCAAC -> TGATAGCAACA
TTGCAGAACTT -> TGCAGAACTTC
TTGCAGACAAC -> TGCAGACAACT
TTGCGTTTTGA -> TGCGTTTTGAG
TTGGCCTGCCC -> TGGCCTGCCCA
TTGGCGCCCGT -> TGGCGCCCGTG
TTGGGAGTTAG -> TGGGAGTTAGA
TTGGGATGACT -> TGGGATGACTC
TTGGGCCGGGC -> TGGGCCGGGCT
TTGGGGCGTCG -> TGGGGCGTCGT
TTGGGGTATGC -> TGGGGTATGCC
TTGGTCTCAGA -> TGGTCTCAGAC
TTGTACGTCGC -> TGTACGTCGCG
TTGTCACGCTT -> TGTCACGCTTG
TTGTCATAATA -> TGTCATAATAG
TTGTCATTATC -> TGTCATTATCT
TTGTCCGTAAC -> TGTCCGTAACG
TTGTCGCGGAT -> TGTCGCGGATA
TTGTCTTCCTT -> TGTCTTCCTTA
TTGTGCAATAG -> TGTGCAATAGG
TTGTGTATGCA -> TGTGTATGCAG
TTGTTTGGGAG -> TGTTTGGGAGT
TTGTTTTATAA -> TGTTTTATAAT
TTTAACCGCCT -> TTAACCGCCTG
TTTAACTCATC -> TTAACTCATCC
TTTACGATGAT -> TTACGATGATC
TTTACGTATGT -> TTACGTATGTT
TTTAGAAATGT -> TTAGAAATGTT
TTTAGGAGTTG -> TTAGGAGTTGA
TTTAGTCGTGG -> TTAGTCGTGGT
TTTATAATCAG -> TTATAATCAGC
TTTATCGCTGG -> TTATCGCTGGA
TTTATGAAGTT -> TTATGAAGTTC
TTTCAGACCCC -> TTCAGACCCCA
TTTCCCGCCGG -> TTCCCGCCGGG
TTTCCTTAAAC -> TTCCTTAAACA
TTTCGAAAACA -> TTCGAAAACAC
TTTCGCGGATA -> TTCGCGGATAC
TTTCTCAGTTC -> TTCTCAGTTCA
TTTCTCCGATA -> TTCTCCGATAG
TTTGAGGGGAA -> TTGAGGGGAAT
TTTGGGAGTTA -> TTGGGAGTTAG
TTTGGGATGAC -> TTGGGATGACT
TTTGTCTTCCT -> TTGTCTTCCTT
TTTGTGCAATA -> TTGTGCAATAG
TTTGTTTGGGA -> TTGTTTGGGAG
TTTTATAATCA -> TTTATAATCAG
TTTTCCCGCCG -> TTTCCCGCCGG
TTTTCGAAAAC -> TTTCGAAAACA
TTTTCTCAGTT -> TTTCTCAGTTC
TTTTCTCCGAT -> TTTCTCCGATA
TTTTGAGGGGA -> TTTGAGGGGAA
TTTTGTGCAAT -> TTTGTGCAATA
TTTTGTTTGGG -> TTTGTTTGGGA
TTTTTCGAAAA -> TTTTCGAAAAC
TTTTTGTGCAA -> TTTTGTGCAAT
TTTTTTGTGCA -> TTTTTGTGCAA
